《币圈笔记》1264期：消息需要看何时兑现	bihu
【1106】connext.network 跨链测试-埋伏盲测	bihu
【DeGate-L2Show】介绍BOBA Network	bihu
11月16日 ：最近24小时区块链重要信息汇总及行情简报； 元宇宙发展的几个方向	bihu
1阿飞的TUMI	bihu
2021年11月16日《区块链每日必知》以太坊累计销毁超88万枚ETH	bihu
8分钟区块链	bihu
a.bat-s.pro	bihu
ADAMoracle实验室启动ADAM代币映射升级	bihu
Ares跨链预言机	bihu
Axie Infinity收入下滑 GameFi如何演进？	bihu
a汤圆	bihu
biozlm	bihu
Bold Point：角色扮演+边玩边赚GameFi链游 与Kalao合作	bihu
BSN港澳国际门户正式上线，数智节点DXN建设运营	bihu
chainnews.com	bihu
CherrySwap旗下链游CyberCat将更新路线规划，预计部署OEC及BSC。	bihu
Cointelegraph中文	bihu
CoinUp冲进全球排名前18%	bihu
Cosmostation作为验证者加入CUDOS生态系统	bihu
Cronos生态升温，手把手带你Cronos跨链	bihu
CUDOS	bihu
CUDOS小文 | 为什么元宇宙使互联网去中心化更加必要？	bihu
DAOSquare	bihu
das注册教程 埋伏下一个域名空投	bihu
DeFiEye	bihu
DeFi每日关注	bihu
DeGate爱好者	bihu
ENS究竟是什么，它的价值有多大？	bihu
EOSCannon	bihu
EOS西站社区	bihu
Gala Games被称为链游的steam，将引领下个时代！	bihu
GALA币能涨到多少？GALA币未来发展趋势分析	bihu
GameFi元年，从游戏与游戏平台两个方向蓄力	bihu
Kaco Finance 上线新单币无损挖矿，质押 KAC 获取高额年化收益	bihu
Kalao合作的边玩边赚GameFi链游：Bold Point开启新篇章	bihu
KaraStar小白教程，币安参投。登录空投10XDAI。	bihu
KTS规则	bihu
MILIT即将发布装备系统，以及重铸系统	bihu
Moni Battle虚拟仓投资比赛，参与赢取丰厚奖励！	bihu
mp.weixin.qq.com	bihu
Multicoin领投的UXD能打破现有稳定币的格局吗？	bihu
mzwh3000	bihu
NFTimes 2021#18 Beeple拍卖创新高，Twitter入场Crypto	bihu
NFT初创公司屡获大额融资，NFT开发会是一门好生意吗？	bihu
NFT谷歌搜索量飙升至历史新高	bihu
Nora007	bihu
Nora正在续写元宇宙游戏行业中加密货币的神话！	bihu
Number:用技术改变这个造假、篡改的世界	bihu
POWR币怎么样？适合长期持有吗？	bihu
Secret Network：Sienna Network 与 Stashh 合作	bihu
Secret网络	bihu
Skybridge Capital 创始人称比特币“将轻松交易至 50 万美元”	bihu
sm加密文件	bihu
TLC推广任务启动，海量TLC送不停，单个地址最少可享价值18U 奖励	bihu
Tomorrow币有	bihu
阿好	bihu
安联首席经济学家：当投机者被“动摇”时才会再次购买比特币	bihu
八哥淡币	bihu
白嫖NFT power sister	bihu
北交所开了！虹吸效应致比特币暴跌！股票房价哪个更套路？指望牛市最后几天涨是不切实际的想法	bihu
比特币行情跌幅扩大，但市场看涨情绪仍然强势	bihu
比特小居士	bihu
币吧	bihu
币圈de精灵	bihu
币圈北斗	bihu
币圈磊哥666	bihu
币圈拈花公主	bihu
币圈一级市场：Bold Point：角色扮演+边玩边赚GameFi链游 与Kalao合作 知道期待	bihu
币文哥	bihu
币赢网Coinw	bihu
币友_1048601302	bihu
币友_1343630344	bihu
币友_1604061932	bihu
币友_1782269893	bihu
币友_317567	bihu
币友_501906	bihu
币友_52494	bihu
币友_无名	bihu
币有所成丶	bihu
必踢谁	bihu
财经视野	bihu
残云戏香雪	bihu
炒币人为什么要把安全放在第一位？	bihu
沉默是金！赚哥保持币圈初始之心不变！蛋总在新事物面前接受力强！吴老湿元宇宙新认知！‖	bihu
橙链_脑韭菜	bihu
橙链达哥	bihu
吃葡萄的人	bihu
出事的原因找到了，MTgox赔付事件引发雪崩！市场恐慌比特币放量暴跌	bihu
从经济发展看通证经济局面！	bihu
达瓴智库	bihu
大家一起吃肉	bihu
大头小蚂蚁	bihu
大头小蚂蚁区块链学习笔记161：Ontology专注搭建底层可信数据的公链	bihu
大头小蚂蚁区块链学习笔记162：阻挡不住的需求就是未来，DEFI有未来	bihu
大众与核心：读懂 DAO 的生态现状与变革潜力	bihu
低调起飞的链游风口已至	bihu
对与错辩析！美司法部收回大量被盗加密货币！马斯克持续被Burry嘲讽！加密货币占投资组合10%！‖	bihu
发改委发言人孟玮：虚拟货币“挖矿”行为存在极其严重的危害	bihu
发送和接收加密产品更容易：XcelPay钱包上启用了FIO协议	bihu
反指	bihu
飞扬跋扈的小白兔	bihu
非比寻常	bihu
分析潜力币POLY的可能性！	bihu
蜂巢财经News	bihu
刚刚，农民世界突破60亿！	bihu
拱墅：按下聚才“快进键”跑出发展“加速度”	bihu
关于Gamestarters 打新，看这篇就够了！	bihu
过去一段时间内，Crypto在体育产业有着怎样的表现？	bihu
韩国加密税确定将在明年初实行，而非2023年	bihu
韩国立法机构听取讨论“知道发件者KTS”规则，或成最严加密交易报告要求	bihu
黑猫白猫	bihu
黑米男神	bihu
红红再火火	bihu
鸿运之年	bihu
虎符已登上国际舞台，HOO成名副其实的“金铲子”	bihu
花木兰	bihu
黄保长币投日记	bihu
黄金矿工跑路风波，链游风险提示，车厘子链游将跨到BSC！	bihu
黄天威提醒冷静看元宇宙概念。托尼成为了灵魂画手，他画的点能到吗？链游项目黄金矿工跑路一波三折。	bihu
火小律：币圈那些事，究竟会否被套上非法经营	bihu
火种研究院	bihu
机会是跌出来的 怕啥？ 院长说币行情分析（11/16）	bihu
即将爆火的GameFi赛道，那些项目才是GameFi未来？	bihu
即将上线Coinbase的GALA，GALA有什么魅力？	bihu
即将上线Coinbase的GALA，价格飙升	bihu
加关注	bihu
加密部落	bihu
加密部落日报2021.11.16之寻找优质项目	bihu
加密行业的隐私和监管 你会如何站队？	bihu
佳伦链茶馆	bihu
价值上亿的币20多万就卖了，牛尾的波动有点大，社交媒体直接左右着币市行情	bihu
简单验证dis，领mars	bihu
江卓尔：囤ETH，做区块链地主；大宇的持仓原则；李法师踏空又看空，牛走了？？？	bihu
将白嫖进行到底	bihu
降维打击之下，币乎若能撑过去，或许就是真的笑到最后||凉兮慌不择食？	bihu
交易者仍然期望到BTC 1 月达到 8 万美元。	bihu
接近人均40000空投的ENS究竟有何魔力？	bihu
接下来 3 周的时间里，字节元社区将福利送不停，带来源源不断的活动	bihu
杰哥	bihu
今日大盘暴跌是熊市的到来还是回调继续创新高	bihu
今日恐慌与贪婪指数为71，贪婪程度有所下降	bihu
金湖居士	bihu
尽管交易量回落，机构比特币产品资产管理规模仍创下新高	bihu
锦瑟币58078	bihu
近日法国xcash公司创始人表示；隐私保护永远都是重点	bihu
决无锦有	bihu
崛起币	bihu
蓝调99	bihu
老白的习惯。现在市场处于什么位置?预期空投。巨鲸的钱包地址。凶真：我对人类失望透顶。北交所来了。	bihu
老姚说财经	bihu
乐游区块链	bihu
李法师看空北纬看多谁能胜出？赚哥的策略不瞎折腾；粉红梦庄园囤币联盟成立～	bihu
链改直通车	bihu
链上地址翻译官ENS为何走红？	bihu
链游项目FarmersWorld（农民世界）市场分析	bihu
刘教链	bihu
流浪大侠	bihu
撸BATX，火币链	bihu
撸BATX，已上火币链	bihu
洛沫	bihu
骆驼camel今满月 XF开屏送祝福	bihu
珞珈山神	bihu
律动BlockBeats	bihu
马斯克玩转股票赚440亿 一个翻五倍以上牛市秘密‖比特币止跌反弹 突破后能否走出新高‖北交所正式开市	bihu
美国总统乔·拜登签署基础设施法案成为法律，规定经纪人报告要求	bihu
美女地主	bihu
门头沟价值26亿美元大饼会砸盘吗？cake的IFO上市，还有哪些游戏值得期待！—黄保长币投日记	bihu
门头沟赔付导致大跌？无需担忧，牛市多暴力洗盘行情，回调是为了更好的上涨！	bihu
米波波	bihu
漠北论币	bihu
慕容说	bihu
哪些价值因素让优秀的Crypto funds产品脱颖而出？ ------好的选择，能带你穿越牛熊	bihu
那年花正开	bihu
南海数字文化产业峰会，新探索数字资产的跨链流通关键技术及应用	bihu
暖暖	bihu
盘中宝——风险资产或将崩盘，BTC巨鲸有抛售迹象	bihu
飘香幽茶	bihu
普及一些只是个概念	bihu
启铭区块链老拾	bihu
启铭社区小马哥	bihu
勤劳致富2021	bihu
清风_明月	bihu
区块链初心	bihu
区块链奋斗狂人	bihu
区块链服务网络BSN	bihu
区块链骑士	bihu
区块链心心	bihu
区块桥之路	bihu
去中心化流动性管理协议 YIN Finance 上线 Gate.io，AMA内容回顾	bihu
圈小白白2	bihu
全新链游Bold Point——角色扮演+边玩边赚GameFi与Kalao合作	bihu
群里发的项目，CERTIK已通过审计了，真的吗？轻松一招不在人云亦云！！！	bihu
热门	bihu
三伯爷	bihu
散户应该玩gamefi?以太坊空投列表；SOL链算稳UXD完成拍卖；比特傻的方法	bihu
沙盒姐姐	bihu
社区最新出炉托管计划 农民世界游戏道具——挖掘机	bihu
是好是坏币友认真看，政府，莫再对虚拟货币心存侥幸。	bihu
是金子总会发光，GALA逆市大涨！	bihu
守望财经	bihu
丨密码极客丨	bihu
数字货币疯人院	bihu
斯坦福加持的隐私金融公链Findora，强势解决市场难题	bihu
随着对加密货币审查的扩大 美司法部成立新的执法小组	bihu
孙宇晨全力打造波场TRON最大去中心化交易所SUNSwap，引领行业新风向	bihu
孙宇晨在苏富比纽约秋拍以7800余万美金拍下阿尔伯托·贾柯梅蒂艺术品《鼻子》	bihu
谈谈关于对趋势的看法，其实赚钱可以很简单，而未来十年圈内圈外都是好时机	bihu
唐华斑竹	bihu
逃脱牢笼	bihu
投资	bihu
推动区块链基础设施建设，先要破解区块链发展“三高”难题	bihu
挖波场孙哥三架马车	bihu
微文	bihu
稳稳的	bihu
无花无酒锄作田	bihu
吾是侠客	bihu
吴说	bihu
西柚资讯	bihu
相期凤凰浴火生——Birbswap的破局之路	bihu
响指研究所	bihu
项目周报 | Ares Protocol 将加入Polkadot平行链插槽竞拍	bihu
萧瑾瑜	bihu
小荷还无尖尖角	bihu
小牛牛兄	bihu
新游上古联盟	bihu
行走	bihu
行走笔记：元宇宙是对本来存在的再发现	bihu
虚拟币矿工	bihu
虚拟人现身直播间 ,首个官方电商虚拟主播获百万老铁观看	bihu
阳光玻璃雨惜	bihu
洋168998233	bihu
一个值得长期埋伏的元宇宙游戏	bihu
一梦难寻	bihu
一位币圈博主分享为什么进入加密领域。小猪借贷持有poap也将获得空投。	bihu
一文了解加密社交新秀平台——dFax	bihu
以南昌为中心布局大数据走廊	bihu
以色列反洗钱法生效影响几何!未来如何看待这个问题？	bihu
以太坊Layer 2全面爆发 四大维度解析谁能领跑衍生品赛道？	bihu
憶雪無痕	bihu
音乐NFT平台Melos明天将在币安发售摇滚巨匠盲盒,一个OpenSea上最便宜的NFT买单诡异激增	bihu
引领财富风口，塑造全球共识，Zeed带你“逐鹿”DEFI世界	bihu
隐私江湖的危与机，Findora将成为黑马级杀手	bihu
隐私时代来临，Findora将成为时代黑马	bihu
用户量TOP15的链游，是WAX和BSC的战场 | 链游周报	bihu
又见	bihu
又是加速季，又见幺蛾子	bihu
与Kalao合作的边玩边赚链游——Bold Point即将发车	bihu
雨后空山	bihu
雨季独醉	bihu
元宇宙到底是个啥	bihu
元宇宙地产是如何征服投资者的？	bihu
元宇宙将给我们的生活和社会经济发展带来五个方面的巨大改变	bihu
长路说币：11.16以太上行受阻承压回落，可关注日线下轨支撑	bihu
长牛的定局：美国政局的清晰化决定了市场基本面	bihu
正确的公链估值模型_一文告诉你 Solana 是否被高估	bihu
知足开心	bihu
指日成功	bihu
中科声龙荣获《中国质量认证监督管理中心》认证证书	bihu
字节元社区	bihu
字节元周刊#11 ENS 空投， DAS 迎来小爆发；Lina 两周岁，庆生活动纷至沓来	bihu
走向朝阳	bihu
$BRIGHT Fairdrop	favorite
$CQT Covalent Query Token Economics | Covalent	favorite
0x Protocol Metrics, News & Trading Activity | 0x Tracker	favorite
A Visual Explanation of Algorithmic Stablecoins | by Haseeb Qureshi | Dragonfly Research | Apr, 2021 | Medium	favorite
A16 | Andreessen Horowitz | Software Is Eating the World	favorite
Aave – Open Source DeFi Protocol	favorite
About the Colony Vision | 去中心化方案供应商	favorite
Acala - The DeFi Hub of Polkadot	favorite
Alchemix	favorite
Ampleforth Liquidity Mining	favorite
AnySwap - Cross Chain DEX	favorite
Arbitrum Bridge	favorite
arweave	favorite
ASTAR Staking Dashboard	favorite
ASTRO	favorite
Augur Foundry	favorite
Augur|不能用美国IP	favorite
Augur测试版发布及使用教程 - 链闻 ChainNews	favorite
avalanche	favorite
Axie Gas Fees	favorite
Axie Infinity – Start your Kingdom	favorite
Babylon.finance	favorite
Balancer	favorite
betting	favorite
BitDAO - Allocate the world's largest DAO-directed treasury, partner with leading protocols, and build the future of finance.	favorite
Bitquery - Blockchain APIs and Crypto Data Products	favorite
Blockscan address	favorite
Bounce 拍卖	favorite
Braintrust	favorite
Bridge Away (L1 Ethereum) ���	favorite
cardano	favorite
Cardano | Home	favorite
Cardano Tokenview	favorite
Cardanoscan - Cardano Explorer	favorite
Cardax – DEX on Cardano	favorite
CardStarter Pools	favorite
Catnip	favorite
cBridge	favorite
centrifuge accounts Substrate Portal	favorite
Centrifuge: Real World DeFi	favorite
Charli3 - The gateway to the decentalized web on Cardano	favorite
clr.fund - Projects	favorite
Coinbase	favorite
CoinDesk: Bitcoin, Ethereum, Crypto News and Price Data	favorite
CoinGecko：加密货币价格与市值	favorite
CoinList is where you access the best new digital assets before they appear on other exchanges - CoinList	favorite
CoinMarketCap	favorite
Convex	favorite
Covalent Platform | Covalent	favorite
Cryptocurrency Compliance Software - Chainalysis KYT	favorite
CryptoFees.info	favorite
CryptoRabit's account | OpenSea	favorite
Curve Swaps	favorite
Curve.fi	favorite
Customer onboarding | KYC & identity verification service	favorite
cyber samurai Solscan	favorite
DailyApe Skill Tree	favorite
DAO	favorite
DAO Pad by DAO Maker	favorite
Dapper Labs - Fun and games on the blockchain	favorite
DappRadar - Ranked list of blockchain dapps	favorite
Dark Forest	favorite
Dashboard — Mirror	favorite
Dashboard - Sonar	favorite
Dashboard | Instadapp	favorite
debank	favorite
Decentraland Events | Decentraland Events	favorite
Deep DAO - Insights for a Decentralized World	favorite
defi	favorite
DeFi - The Decentralized Finance Leaderboard at DeFi Pulse	favorite
DeFi Blog - What is DeFi? Interviews with DeFi projects, analytics, and important news	favorite
defi eye	favorite
DeFi 世界如何实现非足额抵押贷款？一文读懂低抵押 DeFi 贷款赛道现状 - 链闻 ChainNews	favorite
DeFi 与现实的融合：读懂 Maple、TrueFi 与 Goldfinch 等非足额抵押协议 - 链闻 ChainNews	favorite
DefiLlama - DeFi Dashboard	favorite
defi工具平台	favorite
DeFi科普系列之（三）深入理解Synthetix如何玩转合成资产 | by snow | Cortex Labs | Medium	favorite
DeGate	favorite
Deso | The Decentralized Social Blockchain	favorite
dfinity	favorite
DFINITY Cycles Faucet	favorite
DFINITY Foundation | Internet Computer	favorite
DIF - Decentralized Identity Foundation	favorite
Discord	favorite
DOT min stake | Polkaview	favorite
Dragonfly 合伙人：用简单的视觉语言演示稳定币工作原理 - 链闻 ChainNews	favorite
Duck Starter	favorite
duneanalytics.com	favorite
dYdX	favorite
Element | Polkadot Watercooler	favorite
Element Finance - DeFi's fixed-rate protocol	favorite
Eligibility - BrightID	favorite
Enjin | 区块链产品生态系统	favorite
enjin浏览器 - EnjinX	favorite
ENS	favorite
EnterDAO - Building a gateway to the metaverse	favorite
Enzyme	favorite
ETH Hole	favorite
Etherscan China Ethereum (ETH) Blockchain Explorer	favorite
ETH批量查余额 - CoinTool	favorite
Explorer | Solana	favorite
Fantom	favorite
Fantom fWallet	favorite
Feed - BitClout	favorite
FlanoSwap	favorite
Follow the Rabbit	favorite
Fortmatic - Dashboard	favorite
FujiDAO	favorite
Future - Understand the Future, How Tech Shapes It, and How We Build It	favorite
Gala Games	favorite
Ganache | Truffle Suite	favorite
GeroWallet - Your Master Key to DeFi	favorite
Gitcoin	favorite
Gitcoin Governance - Gitcoin is where builders, developers, and protocols come together to build & fund the open web.	favorite
Glassnode：解析 DeFi 稳定币现状与挖矿收益机会 - 链闻 ChainNews	favorite
Gnosis Auction	favorite
Gods Unchained	favorite
Graph	favorite
Graph Docs	favorite
graph kyc	favorite
GraphQL 入门看这篇就够了	favorite
GraphQL快速入门教程 - 知乎	favorite
Graphscan	favorite
Grenade 手榴彈 | 台灣區塊鏈整合行銷社群平台	favorite
Guild of Guardians	favorite
Hacker Noon	favorite
Hegic: On-chain options trading protocol on Ethereum	favorite
hi Dollars | Bitcoin with Benefits	favorite
hi Web | Home	favorite
Home - DEXTools	favorite
Home - Digital Currency Group	favorite
Home | Blockchain Capital	favorite
Home | Pantera	favorite
Home • Blockcast.cc- News on Blockchain, DLT, Cryptocurrency	favorite
Homepage | Kleros	favorite
HowRare.is - Your NFT	favorite
https://blueskyweb.org	favorite
Human Money	favorite
Human Protocol	favorite
icy.tools - NFT trends, price data & tracking	favorite
IDENA: Proof-of-Person blockchain	favorite
Idendity	favorite
Identity Verification by Civic - compliance tools for decentralized finance (DeFi), public blockchains, NFTs, and businesses	favorite
Illuvium	favorite
Immutable X | The first Layer 2 for NFTs on Ethereum	favorite
Immutable X 和 Gala Games 谁更可能成为链游 Steam？ ChainNews	favorite
Introduction 概述 - DeFi Practice Guide DeFi操作指南	favorite
INX | Fully regulated trading platform for digital assets.	favorite
Karura Platform	favorite
keep3r.network	favorite
KeyFi Home Page - Unlock The Future Of Finance	favorite
Kwenta | derivatives trading with infinite liquidity	favorite
L2BEAT – The state of the layer two ecosystem	favorite
L2Fees.info	favorite
Layer2	favorite
ledgerscore	favorite
LedgerScore DocSend	favorite
LiquidityFolio | Find the best liquidity pools & track your returns on Uniswap, Curve, Balancer and Sushiswap	favorite
Liquity | Interest-free liquidity	favorite
List of past IDO IEO and ICOs | CryptoRank.io	favorite
Local development :: Internet Computer	favorite
Magic link	favorite
makerdao Oasis Borrow	favorite
Mango Markets	favorite
Maple Finance	favorite
matic_scan	favorite
Medium	favorite
Messari | Cryptoassets Research Reports	favorite
Messari：探索分布式数字身份 DID 的重要性、案例及前景	favorite
MEV Explore	favorite
mistX	favorite
Moonriver Crowdloan on Kusama | Moonbeam Foundation	favorite
multichain	favorite
Nansen	favorite
nanshen Label	favorite
Next Earth – Blockchain Metaverse Project	favorite
NFT	favorite
notion_dailyape	favorite
Notional Finance	favorite
O3swap	favorite
Omen	favorite
onfido	favorite
Openfinance	favorite
Optimism Gateway	favorite
Opyn | Trade Options on Ethereum	favorite
Orca | The DEX for people, not programs	favorite
Pendle - Liberating Future Yield	favorite
POAP - Homepage	favorite
polkadot	favorite
Polkadot/Substrate Portal	favorite
PolkaProject - All Projects building on Polkadot & Substrate	favorite
Polkastarter - Protocol built for cross-chain token pools	favorite
Polygon Matic Web Wallet v2	favorite
Polymarket - The Global Information Markets Platform	favorite
Portfolio – Arrington XRP Capital	favorite
position	favorite
POSTA - Microblogging for Humans	favorite
Prediction Explorer	favorite
Proof Of Humanity	favorite
Proof of Personhood Passport	favorite
QuickSwap Interface	favorite
Rally : Creator Coins	favorite
Rarible – Create, sell or collect digital items secured with #blockchain	favorite
rarity.tools	favorite
Raydium Liquidity	favorite
Raydium Swap	favorite
Real Vision Videos Explain Finance, Business & The Global Economy	favorite
Red Kite	favorite
RRE Ventures	favorite
Saber | Solana AMM	favorite
Securitize | Digital securities for fund admin, transfer agent,…	favorite
Securitize Payouts	favorite
Self-Sovereign Identity for more Freedom and Privacy - SelfKey	favorite
Shiden Network - Multi Chain dApps Hub on Kusama	favorite
skewAnalytics.专业交易分析_coinbase收购	favorite
Skynet Homescreen | 去中心化自定义门户	favorite
slingshot	favorite
SlowMist Hacked 区块链被黑档案库	favorite
smart contract comparison	favorite
Snapshot	favorite
solana	favorite
Solanalysis	favorite
SolanaProject - All Projects building on Solana	favorite
Solanart	favorite
Solanascan(SOL)	favorite
Solanium	favorite
SolFarm	favorite
Stake your KSM with P2P Validator |	favorite
Staking Rewards	favorite
Star Atlas - Home	favorite
StepFinance	favorite
sto_ido	favorite
Subgraphs | Graph Explorer	favorite
Subscan | Kusama Explorer -	favorite
SundaeSwap - Cardano DEX, ISO	favorite
Swap - Polkaswap	favorite
Synthetix Layer2	favorite
Synthetix 创始人详述项目发展规划：V3 和 V2x 或将剥离成两个产品线 - 链闻 ChainNews	favorite
Tally	favorite
TCR Public Distribution | Tracer Blog	favorite
The Graph Academy	favorite
The Graph Foundation	favorite
The Internet Computer Ecosystem Showcase	favorite
Tinlake | Centrifuge | Decentralized Asset Financing	favorite
Token Terminal	favorite
TokenInsight	favorite
TokenSets	favorite
Tokensoft | Security Token Platform	favorite
Top Identity Tokens by Market Capitalization | CoinMarketCap	favorite
TrueFi | Home	favorite
TrustSwap | Trusted transactions on the Ethereum Blockchain	favorite
UBI Crowdvoucher - Google 表格	favorite
ultrasound.money	favorite
uma - emp-tools	favorite
UMA 还能在合成资产上创造多大想象空间？ - 链闻 ChainNews	favorite
UMA—Universal Market Access	favorite
Uniswap Interface	favorite
Vault | NAOS	favorite
VentureCapital	favorite
Web3.0	favorite
WEB3.0应用	favorite
wei on 3Box	favorite
Welcome | DeFi Saver	favorite
Wing	favorite
Wormhole Solana Bridge	favorite
Yearn.Fi	favorite
yearn.finance	favorite
YGG - Yield Guild Games	favorite
YIELD - DeFi Banking In Your Pocket	favorite
Yup • Social Network for Curators in Web3	favorite
zapper.fi	favorite
zerion	favorite
ZKSwap - 基于 ZK-Rollups 技术同时采用 AMM 模型的 layer-2 去中心化交易所	favorite
zkSync — Rely on math, not validators	favorite
币乎 - 好文有好报	favorite
从基本面角度分析 Avalanche 二度爆发的原因 - 链闻 ChainNews	favorite
存储层	favorite
兑换 | Sushi	favorite
二线dex	favorite
分布式资本	favorite
分析工具	favorite
公链	favorite
固定利率	favorite
合成资产	favorite
键合曲线解释 – Yos Riady·软件工匠	favorite
精选 文章 - 登链社区 | 深入浅出区块链技术博客	favorite
空投一键查询 | Earnifi | Find Crypto Airdrops	favorite
跨链	favorite
跨链 Evodefi	favorite
跨链 xPollinate	favorite
理财平台	favorite
链上”谷歌“ The Graph-Defi资讯-区块天眼APP	favorite
链闻 ChainNews - 区块链新闻快讯资讯信息服务平台	favorite
链闻精选｜读懂如日中天的链游王者 Axie Infinity - 链闻 ChainNews	favorite
区块链导航 Block123 - 区块链项目、区块链公司大全	favorite
热门话题 - Uniswap Governance	favorite
社交媒体分析 | LunarCRUSH Dashboard	favorite
实时聚合监控 SimpleID	favorite
手把手教你玩转NBA Top Shot - 区块链社区 - ChainNode 链节点	favorite
网站排名 Alexa	favorite
稳定币	favorite
现实资产	favorite
项目分析 simpleid- Grafana	favorite
项目介绍 ：UMA——更有趣的合成资产_ 	favorite
新公链 Avalanche 究竟怎么样？盘点 Avalanche 生态早期项目及投资机会 - 链闻 ChainNews	favorite
信用	favorite
衍生品	favorite
一年百倍的DeFi龙头Synthetix，你是不是还不了解？ - 知乎	favorite
一文梳理 DeFi 固定利率項目的機制 - Grenade 手榴彈	favorite
游戏	favorite
这条 Andre Cronje 疯狂喊单的公链究竟有什么？Fantom 生态全景解析 - 链闻 ChainNews	favorite
知名泛欧区块链投资机构 Rockaway Blockchain Fund 对 Centrifuge 的全面分析	favorite
中间件	favorite
中文 YGG White Paper FINAL	favorite
资讯	favorite
最常用工具	favorite
 公司 Alchemy  轮次C轮  领域链创投	8bit
 公司 Alt  轮次B轮  领域链创投	8bit
 公司 Ardana  轮次不详  领域链创投	8bit
 公司 Bamboo  轮次A轮  领域链创投	8bit
 公司 Chipper Cash  轮次C轮  领域链创投	8bit
 公司 ClubNFT  轮次种子轮  领域链创投	8bit
 公司 Forte  轮次B轮  领域链创投	8bit
 公司 GigLabs  轮次未知轮  领域链创投	8bit
 公司 Immunefi  轮次种子轮  领域链创投	8bit
 公司 Matter Labs  轮次B轮  领域链创投	8bit
 公司 Moralis  轮次种子轮  领域链创投	8bit
 公司 Mythical Games  轮次C轮  领域链创投	8bit
 公司 Notabene  轮次A轮  领域链创投	8bit
 公司 PawnHouse  轮次未知轮  领域链创投	8bit
 公司 Pulsr  轮次不详  领域链创投	8bit
 公司 QuickNode  轮次A轮  领域链创投	8bit
 公司 Solidus  轮次B轮  领域链创投	8bit
 公司 Telos  轮次不详  领域链创投	8bit
 公司 The Sandbox  轮次未知轮  领域链创投	8bit
 公司 数字货币集团（DCG）  轮次未知轮  领域链创投	8bit
 融资时间21.10.27  区域不详	8bit
 融资时间21.10.28  区域瑞典	8bit
 融资时间21.10.29  区域不详	8bit
 融资时间21.11.5  区域洛杉矶	8bit
 融资时间21.11.5  区域美国	8bit
 融资时间21.11.9  区域不详	8bit
 融资时间21.11.9  区域美国	8bit
 融资时间不详  区域澳大利亚	8bit
 融资时间不详  区域不详	8bit
 融资时间不详  区域非洲	8bit
 融资时间不详  区域迈阿密	8bit
 融资时间不详  区域美国	8bit
 融资时间不详  区域香港	8bit
 投资方 HG Ventures、Znoff Capital、Crypto Times、Chronos Ventures 和其他战略合作伙伴	8bit
 投资方a16z领投，参与融资的还有D1 Capital、RedBird Capital、The Raine Group、币安、FTX、32 Equity、美国国家橄榄球联盟的风险投资部门、The Chainsmokers的Mantis等公司	8bit
 投资方Andreessen Horowitz（A16z） 领衔新一轮融资，Lightspeed 和 Redpoint 与 a16z 一起首次加入公司的投资者名单。 现有投资者 Coatue、Addition Capital、Panter 和 DFJ 也参与了本轮融资。	8bit
 投资方ConsenSys和Polygon投资者John Lilic等5名加密货币投资者	8bit
 投资方Electric Capital和Blueprint Forest共同牵头，其他投资者还包括Framework Ventures、Bitscale Capital、IDEO Colab、the LAO、BR Capital和North Island Ventures	8bit
 投资方EQT ventures	8bit
 投资方FTX 牵头，SVB Capital 和其他现有投资者，如 Deciens Capital、Ribbit Capital、Bezos Expeditions、One Way Ventures 和 Tribe Capital	8bit
 投资方Galaxy Digital 和 Galaxy Interactive 共同领投了这次种子轮融资，Red Swan Ventures、CMT Digital、Sfermion、Draper Dragon 和 Richard Entrup 均参与其中。	8bit
 投资方Liberty City Ventures牵头，GSR和Exor Seeds也参与了融资	8bit
 投资方Sea Capital 和 Kora Management 共同领投了本轮融资，其它参投机构包括Andreessen Horowitz (a16z)、老虎环球基金、Solana Ventures、Polygon Studios、Cosmos、Animoca Brands 和华纳音乐集团	8bit
 投资方Spartan Group、红杉等公司、Future Fund、Tribe Capital的播客主播、投资人Anthony Pompliano、TokenSoft的首席执行官Mason Borda	8bit
 投资方Tiger Global，Alexis Ohanian的Seven Seven Six、Soma Capital、Arrington XRP Capital、Crossbeam和Anthony Pompliano	8bit
 投资方澳大利亚最大的加密货币对冲基金 Orthogonal Trading、Mountain Ash Investment Management 和 VP Capital	8bit
 投资方软银愿景基金 2 （Vision Fund 2）	8bit
 投资方三箭资本和Ascensive Assets共同领投，cFund、Morningstar Ventures、Mechanism Capital、Kronos Research、FMFW、MGNR、Selini Capital、Skynet Trading和Portico Ventures也参与了此次融资	8bit
 投资方由 a16z Crypto 领投，其他投资方包括 Placeholder、Dragonfly 和 1kx 等，以及Blockchain.com、Crypto.com、Consensys、ByBit、OKEx、Alchemy、Covalent等战略合作伙伴，另外，还有来自AAVE、Paraswap、Lido、Futureswap、Gnosis、Rarible、Aragon、Liquity、Celer Network、Connext、Perpetual Protocol、Euler、Opium等 70 多个项目的创始人或高管参投	8bit
 投资方由 Panoramic Ventures 和 NBA Top Shot 的创建者 Dapper Labs 领投，Collab + Currency、Red Beard Ventures、Eterna Capital、Alumni Venture Group、Gaingels 和 Amino Capital。	8bit
 投资方由 Spearhead（由 Jeff Fagnan 和 Naval Ravikant 共同创建的新型基金。）领投，并得到了Seven Seven Six、Vibe Capital、Breyer Capital、Shrug Capital、Apollo Projects（Max 和 Sam 和 Sam Altman 的公司）、Hyperguap、A* 和一些个人投资者——包括一些体育界的大牌，比如 Tom Brady、Giannis Antetokounmpo、Alex Morgan、Candace Parker 和 Marlon Humphrey。	8bit
 投资方由软银牵头，包括 Ribbit Capital 和 CapitalG（谷歌母公司 Alphabet 的子公司）等参投	8bit
 投资方总部位于芝加哥的Jump Capital和Cambridge，总部位于马萨诸塞的F-Prime Capital领投了这轮融资	8bit
“全宇宙”（Omniverse）平台定位为“工程师的元宇宙”	8bit
《规划》中表示，将开展数字人民币试点，	8bit
《环球时报》：元宇宙，中国企业准备好了吗	8bit
《经济学人》：a16z掌门人探讨 Web3 前景及加密货币未来	8bit
「多链生态」与「跨链之争」。	8bit
「可组合性」之于软件就像「复利」之于金融	8bit
「数字宇宙」韩国巨头抢跑元宇宙的先行策略	8bit
01区块链	8bit
1 天前	8bit
1.5亿美元	8bit
10 小时前	8bit
10 小时前来源：中国网	8bit
1000万美元	8bit
1020万美元	8bit
1070个游戏类Dapp已上线部署，一文盘点那些热门的游戏平台	8bit
11 小时前	8bit
11月中旬，比特币将迎来17年以来的首次技术升级—Taproot	8bit
12 小时前	8bit
12月11-12日，“2021元宇宙大会·万物起源暨区块链创新应用论坛”将在苏州开幕！	8bit
1340万美元	8bit
13年前的今天丨中本聪发布比特币白皮书	8bit
15000万美元	8bit
1500万美元	8bit
200万美元	8bit
2021-10-29来源：CNBC	8bit
2021-10-30来源：IGN Southeast Asia	8bit
2021-10-30来源：U.Today	8bit
2021-10-30来源：巴比特	8bit
2021-10-31来源：Decrypt	8bit
2021-11-06来源：CoinDesk	8bit
2021-11-06来源：微博	8bit
2021-11-07来源：推特	8bit
2021-11-09来源：中国人民银行	8bit
2021-11-10来源：金十	8bit
2021-11-12来源：金十	8bit
2021-11-13来源：SEC	8bit
2021-11-14来源：CoinDesk	8bit
2021-11-14来源：巴比特	8bit
2021年Q3以太坊协议及生态报告	8bit
2021元宇宙大会	8bit
25000万美元	8bit
2亿美元的基金旨在促进Avalanche网络的增长和创新。	8bit
300万美元	8bit
3500万美元	8bit
39 号公投正式完成执行	8bit
3天卷走6000万美元，AnubisDAO从成立到跑路时间线梳理	8bit
4 小时前	8bit
450万美元	8bit
5000万美元	8bit
550万美元	8bit
5分钟了解波卡生态一周发生的大事件	8bit
6天贡献5个涨停板，虚拟房产被炒到53万元，天下秀的虹宇宙到底是个啥？	8bit
7 小时前	8bit
70000万美元	8bit
75000万美元	8bit
7500万美元	8bit
800万美元	8bit
81家公司正在使用区块链技术	8bit
9300万美元	8bit
A16Z	8bit
A16Z 合伙人对话Coinlist创始人：元宇宙的核心是所有权，Meta最终会过时	8bit
a16z：游戏创作者经济未来已来	8bit
A16Zweb3.0	8bit
a16z合伙人对话Coinlist创始人Naval：WEB3.0的奇迹	8bit
All in Metaverse，扎克伯格豪赌一个未来。	8bit
All in元宇宙的Facebook能够带来业绩的二次增长吗？	8bit
AnubisDAO	8bit
AnubisDAO 背后支持者 0xSisyphus 在社交媒体上公布了一份记录 AnubisDAO 从成立到跑路的详细时间线概述	8bit
Arrington Capital：深度剖析波卡平行链设计理念与运作机制	8bit
Avalanche	8bit
Avalanche推出2亿美元基金，以吸引顶尖加密货币开发者	8bit
Axie Infinity向游戏行业展示了基于区块链的游戏所能实现的一小部分，而该行业在不久的将来将迎来爆炸式增长。	8bit
Bankless：2021年Q3以太坊协议及生态报告	8bit
Bankless丨为什么模块化的区块链是加密行业最好的扩容方案	8bit
Block unicorn	8bit
Blockchain Life创始人表示，许多扎根于俄罗斯的加密货币交易所已逃离该国或者在非法经营。	8bit
BlockFi 加入现货比特币 ETF 竞赛，美SEC本周将对首个现货比特币ETF作出最终裁决	8bit
Blocklike	8bit
BlockSec	8bit
BXH被盗，损失约1.39亿美元 ，两个第三方机枪池连环关停充提	8bit
BXH被盗需要反思自身的私钥管理问题	8bit
BXH盗币案反思：黑客用最原始的方式 “摧毁了”国产机枪池 原因与教训是什么	8bit
Chase Chapman 在这篇推文里提出了对DAO多元化的方法的探讨。多元化对于DAO的意义很大	8bit
ChinaDeFi	8bit
Coinbase	8bit
Coinbase Ventures 90% 的投资资金已于 2021 年年初至今投入使用	8bit
Coinbase Ventures Q3投资高达49笔，web3.0和defi两大类别占比超50%	8bit
Coinbase加密工程师yuga日前发推总结11月6日的以太坊社区电话会议，此次会议关键信息包括：合并预计将在2022年第二季度左右进行（可能会发生变化）；合并期间预计不会出现停机，这是一个“共识热交换”；合并将以太坊业务逻辑分为两层，共识层是验证节点对区块、最终性等进行投票，节点客户端包括Prysmatic Labs和Teku，执行层是节点构建区块、验证交易等，客户端包括Geth和Nethermind；合并后节点运营商除了现有的执行节点外，还必须提出一个共识节点；在Staking合约中锁定的...	8bit
Connect 2021大会落幕，让我们再次回顾Meta官方会议总结	8bit
Crowdloan 模块启动和 Auction 启动有什么不同？	8bit
CT中文	8bit
Curve	8bit
Curve Finance 遭 “狗类” 项目「治理攻击」，项目方收割了近 3000 万美元	8bit
DAO	8bit
DAOrayaki	8bit
DAOSquare	8bit
DAO的本质就是一个由许多个人组合起来的群体	8bit
DAO将吞噬互联网	8bit
DeFi	8bit
DeFi 生态系统正在走向成熟	8bit
DeFiCurve	8bit
DeFiNFT	8bit
DeFi是一个共享的机遇和挑战，会真诚地考虑和帮助推动负责任的创新	8bit
DeFi之道丨Spartan Group合伙人：如何不靠运气在加密行业致富	8bit
DeFi之道丨一文了解使用 ZK-rollups 分片的以太坊如何成为一股不可阻挡的务实力量	8bit
Dfinity	8bit
DFINITY，作为区块链行业Web3时代的引领者，其愿景是打造全球第一个区块链计算机- Internet Computer，在这一宏大愿景驱使下，数百位团队成员历时6年潜心开发，于今年5月完成主网上线。	8bit
discord	8bit
Discord 是一家很难读懂的公司	8bit
EBSI是什么？	8bit
EIP-4361描述了使用签名消息的现有web2服务的身份验证方法。	8bit
ENS	8bit
ENS 也大概率会成为 NFT 下一波的热点	8bit
ENSeip4361	8bit
ENS空投在即，为什么说去中心化域名及账户系统对Web3至关重要？	8bit
EPIC GAMES	8bit
Epic Games为何早早布局元宇宙，他们为此做出了哪些努力？	8bit
EVM等效性如何成为L2的下一个通用标准。	8bit
Facebook	8bit
Facebook Connect 2021官方总结：Meta对于元宇宙的愿景	8bit
Facebook（现Meta）旗下VR设备公司Oculus 首席技术官：Meta 可能不会完全向加密世界开放	8bit
Facebook更名Meta，虚拟与现实的极致结合	8bit
Facebook是新的数字国王，而哪个国王愿意放弃他的王国？	8bit
Facebook宣布更名为Meta，其元宇宙将支持NFT	8bit
Facebook元宇宙	8bit
Facebook元宇宙meta	8bit
Facebook正式改名Meta，一个元宇宙新纪元由此开始	8bit
Facebook正式更名为Meta，元宇宙的时代要到来了吗？	8bit
Falling for DeFi on Findora。	8bit
FATF	8bit
FATF 的最新指南对 DeFi、稳定币和自托管钱包意味着什么？	8bit
FATFDeFiNFT	8bit
FATF发布终版加密货币指南，包括对DeFi和NFT进行澄清	8bit
Filecoin	8bit
Findora Beta主网上线Staking质押功能	8bit
Findora推出1亿美元生态系统基金	8bit
FVM将成为推动去中心化存储的核心支柱。	8bit
GameFi愈加火爆，先入者赚得盆满钵满	8bit
GitcoinFindora	8bit
Hackathon DAO: 从产业化Hackathon到去中心化的全球Hacker运动	8bit
MetaCreation：元宇宙创作者经济的新范式	8bit
Meta高管三年前就曾提出元宇宙计划 曾想自己构建排除其他公司	8bit
MicroStrategy	8bit
MicroStrategy上季度增持近9000个比特币，其BTC储备目前价值约70亿美元	8bit
Multicoin Capital合伙人Mable：从链上声誉体系看Web3劳动力市场	8bit
Mytrol数字文创空间	8bit
NFT	8bit
NFT 的发展还只是刚刚起步而已，未来一片光明	8bit
NFT 和文化的交集，将在未来几年推动用户大规模增长	8bit
NFT 仅是头像？脑洞大开设想 NFT 未来的无限用例	8bit
NFTCryptoPunks	8bit
NFTParallel	8bit
NFT初创公司屡获大额融资，NFT开发会是一门好生意吗？	8bit
NFT还是一个比较新的领域，在游戏和音乐等方面，NFT越来越受到关注	8bit
NFT火爆全球，游戏公司SandBox获得9300万美元融资，软银领投	8bit
NFT开发商正在受到资本的青睐。	8bit
NFT链游	8bit
NFT是Web3.0多元宇宙的重要组件	8bit
NFT艺术将取代传统艺术吗？	8bit
NFT元宇宙	8bit
NFT周刊｜Beeple创下销售新纪录，Coinbase CEO看好NFT	8bit
NFT周刊丨BTS乐队发布NFT;Solana的销售额已经超过5亿美元；电影或将被引入NFT领域	8bit
Oculus高管杰森·鲁宾(Jason Rubin)早在2018年就曾提出元宇宙计划，并将其发给相关高管和董事会成员。	8bit
PANews	8bit
Paradigm	8bit
Paradigm联合创始人Matt Huang加入支付巨头Stripe董事会	8bit
Polkadot 42 号公投已通过，Crowdloan 模块已启动！	8bit
Polkadot 即将启动 Shell 平行链	8bit
Polkadot 平行链插槽 Auction 正式启动，一起来看看具体的时间安排	8bit
PolkaWorld	8bit
Real Vision创始人对话Vitalik：以太坊没有杀手级应用，只有杀手级生态系统	8bit
Riot Game前高管：游戏玩家将成为Web3真正粉丝的15大原因	8bit
Rust 智能合约养成日记: 合约安全之重入攻击	8bit
Rust合约安全之重入攻击。	8bit
Schnorr签名taproot比特币	8bit
secDeFi	8bit
Shaan Puri被罗永浩称之为“超过扎克伯格对元宇宙概念的理解”	8bit
Shaan Puri对元宇宙的理解有何特殊之处？从罗永浩的博文说起	8bit
SolanaEVM	8bit
Steam拒绝了区块链游戏，是否说明主流游戏行业依然对区块链怀有偏见？同样是游戏发行平台，Epic为什么欢迎区块链游戏？	8bit
Synthetix创始人：DeFi 之夏并非巅峰，它和以太坊的壮丽未来就在眼前	8bit
taproot	8bit
Taproot 激活表明比特币可以再次进行网络升级，这对于比特币网络的长寿极为重要。这是最大的胜利。	8bit
taproot比特币	8bit
Taproot激活前瞻，一文了解Bitcoiner该做什么	8bit
Taproot将提高比特币作为价值存储和交换媒介的可行性	8bit
Tornado.Cash 真的匿名吗？	8bit
Twitter 和 Facebook 仍然会很好，会继续存在， 但我们将关注的是由NFT和token等原语独特启用的新应用程序	8bit
Twitter 已聘请 Tess Rinearson 领导新的 Twitter Crypto 团队	8bit
Twitter、Facebook、Reddit、Discord的加密征程分别如何？	8bit
Twitter成立加密团队「Twitter Crypto」以探索去中心化应用程序	8bit
UXD能打破现有稳定币的格局吗？	8bit
Valkyrie撤回其杠杆比特币期货ETF申请	8bit
VanEck的比特币现货ETF在经历数次延期后终被拒。	8bit
Vitalik Buterin：加密城市的时代已经到来	8bit
Warpspeed 2021 DFINITY×IAF首次中国黑客松报名正式启动，寻找中国最极客的开发者！	8bit
Web 3.0改变了每个主要行业	8bit
Web2.0 时代的公司犯下了哪些罪证？Web3能否跨越Web2的社会陷阱	8bit
Web3 社交降低了参与的信任负担	8bit
web3.0	8bit
Web3的意义远远不止于加密货币或投机	8bit
web3跨链	8bit
Web3时代的多链宇宙，你更看好哪一种形态呢？	8bit
X-Order	8bit
Yangz	8bit
Yearn Finance创始人Andre Cronje称其为 "惊人的骗局"	8bit
zk rollup才是Rollup的未来。	8bit
安全漏洞智能合约	8bit
巴比特讯，11月12日，美国证券交易交易委员会（SEC）宣布对Terra开发公司Terraform Labs和其联合创始人兼首席执行官Do Kwon提起传票执法行动，要求Terra遵守有关文件和证词的调查传票，并正在调查Terraform Labs、Do Kwon是否违反联邦证券法规则，包括未登记证券销售、未注册经纪商或交易商、未注册投资公司从事证券交易。不过，SEC当前正在继续进行实况调查，迄今为止，尚未得出任何个人或实体违反联邦证券法的结论。 SEC称，根据目前进行的调查，有理由相信Terr...	8bit
巴比特讯，11月6日报道，巨人网络集团董事长史玉柱在微博上表示，元宇宙没有统一的定义，100个人有100个定义和描述。元宇宙时代必然来临但不是眼下，其发展是渐进的，还有些基础问题需要解决，比如VR眩晕等硬件问题、网络延迟、基于区块链的经济系统合规性、云端算力等问题。游戏的障碍少些，其他应用场景的障碍多些。元宇宙的研发，需要多些耐心，少些浮躁。 ​​​	8bit
巴比特讯，据欧科云链链上大师数据显示，当前比特币区块高度709626，距离Taproot升级区块高度709632还有6个区块，预计将于1小时内达到预定区块高度。	8bit
巴比特专栏 | 白士泮：中国有潜力在构建真正连接全球的元宇宙上扮演积极角色	8bit
巴比特资讯	8bit
白话区块链	8bit
白话元宇宙	8bit
白士泮	8bit
白泽研究院	8bit
百度副总裁马杰：实现元宇宙 技术要过三道坎	8bit
拜登政府报告：国会需尽快通过稳定币立法，并限制发行人为受保银行	8bit
伴随技术的发展成熟，各个行业都会找到在元宇宙中的应用。？	8bit
本次攻击是典型的利用闪电贷进行价格操控	8bit
本文将具体分析该事件过程	8bit
本文主要讨论对 Parallel 协议和其他收藏类卡牌游戏（CCG）/ 交易类卡牌游戏（TCG） IP 的看法。	8bit
比特币	8bit
比特币ETF	8bit
比特币ETFbito	8bit
比特币Taproot升级倒计时三天！一文了解它将产生哪些影响	8bit
比特币Taproot升级在即，你需要了解它的来源、内容与影响是什么？	8bit
比特币Taproot升级终于要来了！一文了解它的过去、现在与未来	8bit
比特币网络顺利完成Taproot软分叉升级，为什么它的意义如此之大？	8bit
比特币现货ETF再次被拒！一文剖析VanEck ETF被拒原因	8bit
比特币在激活Taproot时会发生什么？这些安全措施我们要做好	8bit
比推Bitpush.news	8bit
比原链	8bit
比原链NFT	8bit
比原链元宇宙：一次激进市场的落地尝试	8bit
波卡	8bit
波卡“双十一”平行链插槽拍卖进入倒计时，多项预热活动开启丨波卡周报	8bit
波卡web3.0Rollup	8bit
波卡科普丨除了平行链，通过平行线程也能参与波卡生态？	8bit
波卡平行链	8bit
波卡如何做到价值捕获？我们又该如何评估波卡所承载的价值？	8bit
波卡生态研究院	8bit
波卡周报丨众多项目积极迎接波卡“双十一”，首轮竞拍竞争激烈	8bit
不报告是重罪！美国投资者炸锅了，基础设施法案将会带来哪些影响？	8bit
不要让“炒作”掩盖了更长期的技术趋势。	8bit
畅谈元宇宙十大商业模式，看看哪款适合你	8bit
超强VR设备+火爆链游+……苏州元宇宙大会带你深度体验“未来世界”	8bit
橙皮书	8bit
尺度区块链	8bit
除了拍手称好，Facebook更名“Meta”后的其他声音	8bit
创新还是炒作？“网红股”AMC将考虑和好莱坞合作推出NFT	8bit
此次插槽拍卖到底有何意义	8bit
此次更新指南中遗漏了两件很重要的事情	8bit
从创作者的不同等级，看Web3世界中创作者经济的痛点与机遇	8bit
从底层到应用，一文纵览热门元宇宙概念区块链项目	8bit
从蜜月到决裂，密码学家尼克·萨博为何对以太坊的态度发生转变	8bit
从人类发展历史看，虚实之间的平衡将会变得越来越困	8bit
达鸿飞	8bit
达鸿飞谈NFT的未来：聚焦多元属性和用户核心	8bit
打破NFT定价和流动性匮乏“魔障”，比原链“激进交易协议”会是NFT未来吗？	8bit
大胆进军NFT？还只是个想法	8bit
大风刮来2万元！ENS大额空投引爆市场情绪，苏州元宇宙大会一大波赠送NFT正在路上…	8bit
大约两周后，比特币将迎来它最重要的技术升级之一：Taproot。	8bit
单片式区块链的时代即将结束，模块化区块链的时代正在到来	8bit
当NFT艺术藏品遇上双十一，七日无理由退货还适用吗？	8bit
当受到监管时，稳定币可以“支持更快、更高效、更包容的支付选择”	8bit
当元宇宙奇点发生时，究竟是好事还是坏事呢	8bit
到底什么是原宇宙？	8bit
迪士尼CEO：元宇宙是迪士尼的未来，迪士尼会成为元宇宙“最快乐的地方”	8bit
迪士尼将未来押在了元宇宙。	8bit
迪士尼元宇宙	8bit
调查 | 全球TOP100上市公司的区块链应用现状：具体应用、投资概况、员工数量及其对加密货币的态度	8bit
东寻	8bit
多个元宇宙平台的互通连接、各个角色的共同参与，才能形成真正的元宇宙	8bit
多链生态的“竞赛”如火如荼：一文说透多链网络的特性和优势体现	8bit
俄罗斯加密行业高管：虽监管不力，但俄罗斯加密市场仍价值5000亿美元	8bit
二级市场元宇宙热持续高涨。	8bit
发改委：将以产业式集中式“挖矿”、国有单位涉及“挖矿”和比特币“挖矿”为重点开展全面整治	8bit
分布式资本	8bit
分片	8bit
分片技术有没有缺陷呢？	8bit
分析：五大原因解释为什么链游是未来发展趋势	8bit
蜂巢Tech	8bit
冯世文律师	8bit
复盘比特币期货ETF上线 更重要的现货ETF还有哪些阻碍	8bit
复盘稳定币USDM团队“Rug Pull”事件，损失约合4,600万美元	8bit
该报告强调了稳定币在生态系统的重要性，也承认其具有风险并提出了相关建议	8bit
该基金名为「BlockFi NB 比特币 ETF」，将提供对比特币的直接敞口	8bit
刚融资 4000 万美元的 Solana EVM 兼容开发团队为何获得 Jump Capital 青睐？	8bit
隔夜的粥	8bit
根据报告显示，CBDC逐渐成为了最值得注意的资产	8bit
根据英国的一项新研究表明，大多数游戏工作室已经开始为即将推出的游戏探索区块链技术。	8bit
公链	8bit
构成比特币的各个拼图的有这些构成的？	8bit
构建元宇宙需要国家的力量和领导	8bit
谷歌前CEO对“元宇宙”大泼冷水：AI技术是“伪神”	8bit
观察 | 如何创建多元化的DAO？	8bit
观察 | 下一波Web 3.0的浪潮将涌向Youtube、Spotify和Facebook	8bit
观察 | 一文纵览微软的元宇宙布局	8bit
观察 | 以赛促教，各类区块链大赛成为高校和创业团队的练兵场	8bit
观察 | 元宇宙可能从哪些方面重塑产业布局？中美日韩元宇宙发展现状如何？	8bit
观点 | DAO的革命：颠覆性的力量DAO的革命：大众与核心都是蹑着猫步而来	8bit
观点 | 没有量子安全，区块链的未来是不确定的	8bit
观点 | 如何评估区块链技术的无形资产价值？	8bit
观点 | 为什么说比特币的打浦路（Taproot）比你想的宽	8bit
观点：以太坊是元宇宙的基础设施，所有道路都会通往以太坊	8bit
国家发改委：各省区市要坚决贯彻落实好虚拟货币“挖矿”整治工作的有关部署	8bit
国资委出台新规深化法治央企建设，“点名”运用区块链等新一代信息技术	8bit
合约漏洞ParadigmEtherscan	8bit
赫美兹数字坊	8bit
黑客cream	8bit
黑客DeFi	8bit
后Taproot时代：重新审视比特币在多链格局中的定位与叙事	8bit
后续比特币 ETF 将逐渐失去先发优势	8bit
互联网元宇宙概念股狂欢，区块链加持的元宇宙又将走向何方？	8bit
华尔街见闻	8bit
获得 Paradigm 投资的 NFT 游戏 Parallel 将如何颠覆卡牌游戏细分市场 ?	8bit
基础设施法案中究竟隐藏了哪些对加密行业的不利措施呢？	8bit
激进交易只是比原链元宇宙的一个组成部分，未来的比原链元宇宙将是一个更加活动的版图和世界。	8bit
激进市场理论，在区块链是最好的试验场，我们同时也在期待比原链MAZ元宇宙NFT市场的到来。	8bit
极客运动真正起飞是在开放源码软件开始巨大增长的时候。	8bit
即将到来的Taproot升级将为比特币带来什么	8bit
继Facebook更名Meta高调进军元宇宙后，微软将通过两项举措发展元宇宙。	8bit
加密货币	8bit
加密货币苹果	8bit
加密货币印度	8bit
加密行业	8bit
加密行业密切关注的加密经纪人定义未能得到修订	8bit
加密资产CBDC	8bit
价值5亿美元的CryptoPunk？为什么这次NFT的破纪录销售似乎有所不同	8bit
监管	8bit
监管sec	8bit
监管稳定币	8bit
建立在区块链技术上的去中心化世界能否在与大规模量子计算机的噩梦之战中获胜？	8bit
荐读 | 万字长文详解DAO的发展历史、类别、文化和发展前景	8bit
江西省政协原副主席肖毅被“双开”，滥用职权引进支持企业从事虚拟货币“挖矿”。	8bit
截至9月30日，MicroStrategy持有114042个比特币，平均购买价为27713美元。	8bit
解码元宇宙 | 沈阳：全世界都在谈元宇宙，它到底有多重要？	8bit
今年融资已达25.6亿美元，链游的火爆能持续多久？	8bit
尽管面临挑战，但加密城市的时代已经到来。	8bit
经济系统是元宇宙的核心要素之一	8bit
据CNBC 10月29日报道，Facebook周四宣布将公司名称更改为“Meta”。公司股票代码将从12月1日起从“FB”变更为“MVRS”。扎克伯格在公开信中写道：“我们希望在未来十年，元宇宙将覆盖十亿人，承载数千亿美元的数字商务，并为数百万创造者和开发者提供就业机会。”扎克伯格预测，元宇宙的元素可能会在5到10年内成为主流。该公司预计“在元宇宙达到规模之前，将在未来几年内投资数十亿美元”。 扎克伯格在信中提到，“从第一天起，隐私和安全就需要被植入元宇宙。开放标准和互操作性也是如此。这不仅需要...	8bit
据CoinDesk 11月14日消息，在印度总理Narendra Modi主持召开关于加密货币在该国的未来的会议后，消息人士告知媒体Asia News International（ANI），虽然政府认识到与加密货币有关的风险，但它打算在这个问题上采取“渐进式（progressive）”和“前瞻性（forward-looking）”的步骤。ANI在推特上写道：“人们强烈认为，应该停止通过许诺和不透明的广告来误导年轻人的企图。大家还一致认为，政府在加密货币和相关问题领域采取的措施将是渐进式和前瞻性的...	8bit
据CoinDesk消息，11月6日，美国众议院以至少218票赞成的表决结果投票通过了基础设施法案，其中包含加密货币纳税申报要求的条款，目前该法案已送交美国总统拜登签字。接下来美国财政部仍需解释其计划如何解读该法案，并发布指导意见，阐明企业或其他实体必须如何遵守该法案。	8bit
据Decrypt 10月31日消息，Meta （原 Facebook）旗下头戴式 VR 设备公司 Oculus 的首席技术官 John Carmack 在 Meta 元宇宙的主题演讲中称，Meta 可能不会完全向加密世界开放。John Carmack 表示，Meta 会支持加密货币交易，但可能不会是一个完全开放的加密友好平台，虽然他个人很喜欢像加密货币这样可以实现在全球范围内不受阻拦地进行现金转账，但同时也在被诈骗等问题困扰。	8bit
据IGN Southeast Asia 10月29日消息，在第二季度财报电话会议中，游戏巨头育碧（Ubisoft）首席执行官Yves Guillemot证实，育碧既想投资使用区块链的公司，也想创造自己的区块链游戏。据悉，Animoca Brands最近完成6500万美元融资，育碧参投。除了投资Animoca Brands之外，育碧还是区块链游戏联盟的创始成员，并且从早期开发开始就一直在探索这项技术。 育碧首席财务官Frédérick Duguet表示，可能会看到区块链以某种形式的新货币化策略最终...	8bit
据U.Today 10月29日消息，彭博高级ETF分析师Eric Balchunas称，美国加密资产管理公司Valkyrie Investments已撤回其推出1.25倍杠杆比特币期货ETF的计划。此前华尔街日报称，美国证券交易委员会（SEC）已要求Valkyrie撤回该申请。	8bit
据金十 11月10日报道，腾讯今日发布2021年度第三季度财报。财报显示，腾讯第三季度营收1423.68亿元人民币，市场预估1454.1亿元人民币；同比增长13%；第三季度净利润395亿元人民币，市场预估326亿元人民币。同比增长3%。财报发布后，腾讯CEO马化腾在业绩电话会议上表示，公司拥有大量探索和开发元宇宙的技术和能力。只要用户体验合规，预计国内对元宇宙的态度是支持的。	8bit
据金十 11月12日消息，国家发改委组织召开虚拟货币“挖矿”治理专题视频会议，通报虚拟货币“挖矿”监测和整治情况，并对下一阶段工作进行部署。会议强调，各省区市要坚决贯彻落实好虚拟货币“挖矿”整治工作的有关部署，切实负起属地责任，建制度、抓监测，对本地区虚拟货币“挖矿”活动进行清理整治，严查严处国有单位机房涉及的“挖矿”活动。	8bit
据慢雾MistTrack消息，去中心化交易协议BXH于今日在BSC链遭到攻击，目前，初始黑客获利地址（BSC: 0x48c94305bddfd80c6f4076963866d968cac27d79）已将4000 ETH从BSC链转移到ETH链，接着将300 BTCB兑换为renBTC跨链到地址 （1Jw...9oU和1Fr...Vow）。慢雾AML将持续监控被盗资金的转移，拉黑攻击者控制的所有钱包地址，提醒交易所、钱包注意加强地址监控，避免相关恶意资金流入平台。 此前消息，BXH团队表示在⽕币⽣...	8bit
据中国人民银行官网 11月9日消息，中国人民银行行长易纲表示，人民银行从2014年起开始研究法定数字货币。截至今年10月8日，数字人民币试点场景已超过350万个，累计开立个人钱包1.23亿个，交易金额约560亿元。下一步，我们将根据试点情况，有针对性地完善数字人民币的设计和使用。一是参考现金和银行账户管理思路，建立适合数字人民币的管理模式；二是继续提升结算效率、隐私保护、防伪等功能；三是推动数字人民币与现有电子支付工具间的交互，实现安全与便捷的统一；四是完善数字人民币生态体系建设，提升数字人民币...	8bit
据中国网报道，国家发展改革委定于11月16日上午10:00召开11月份例行新闻发布会，国家发展改革委新闻发言人介绍有关情况，并回答记者提问。发改委表示，11月10日，国家发展改革委组织召开虚拟货币“挖矿”治理专题视频会议，通报虚拟货币“挖矿”监测和整治情况，部署了下一阶段工作，要求各省区市切实负起属地责任，建制度、抓监测，对本地区虚拟货币“挖矿”活动进行清理整治，严查严处国有单位机房涉及的“挖矿”活动。下一步，我们将以产业式集中式“挖矿”、国有单位涉及“挖矿”和比特币“挖矿”为重点开展全面整治。...	8bit
凯尔	8bit
看元宇宙文章百篇，不如亲身体验！	8bit
科技巨头争相布局元宇宙 多个区块链项目成功融资	8bit
科普 | V神提到的作为以太坊可扩展性未来的分片是什么？	8bit
科普 | 一文详解欧洲区块链服务基础设施（EBSI）	8bit
库克承认个人持有加密货币，但苹果短期内不接受加密货币支付	8bit
跨界！破圈！携手英伟达、星火·链网、科技业神秘巨头，苏州元宇宙大会释放无尽想象力！	8bit
快讯	8bit
了解什么是EVM等效性，它如何成为Layer2的通用标准	8bit
历史会按照一个节奏行进，但不是所有人都能踩准节奏。	8bit
链捕手	8bit
链得得	8bit
链上治理	8bit
链闻	8bit
链新	8bit
链游	8bit
链游和NFT正处于繁荣时期，未来将怎么发展？	8bit
链游两月融资超14亿美元，马云、红杉中国入局	8bit
链游元宇宙	8bit
刘斌Liubin	8bit
慢雾 AML：“揭开” Tornado.Cash 的匿名面纱	8bit
慢雾科技	8bit
毛球科技	8bit
每个人心中都有一个元宇宙。	8bit
每周5分钟，一起探索元宇宙发生的大事件！	8bit
美 SEC 专员：DeFi 必须解决透明度和匿名性问题	8bit
美SEC委员剖析DeFi风险、监管和机遇：会帮助推动负责任的创新	8bit
美SEC向Terra开发公司和CEO提起传票执法行动	8bit
美国加密货币新战场：从华尔街走向华盛顿	8bit
美国跨部门报告：关于稳定币的风险和建议	8bit
美国总统拜登正式签署基建法案，将会给加密行业带来哪些影响？	8bit
美众议院通过含加密税收条款的基础设施法案，已送交美国总统拜登签字	8bit
目前的技术离元宇宙成为现实还有多远？	8bit
目前国内赛事的总体奖金规模为数十万或无奖金支持	8bit
尼克·萨博以太坊	8bit
纽约市长Adams表示他将会鼓励企业接受Crypto并谨慎行事	8bit
欧科云链OKLink	8bit
欧洲央行主管对数字欧元CBDC的使用率提出质疑，称人们可能更喜欢其他Crypto	8bit
平均每10个中国人中就有1人拥有数字人民币钱包	8bit
平行线程进一步降低了团队进入波卡网络的门槛，也合理的分配了资源。	8bit
苹果首席执行官谈比特币支付问题	8bit
屏风	8bit
普京：元宇宙是一种挑战。	8bit
普京：元宇宙无疑是一种挑战	8bit
普通人在元宇宙中寻找机会的两大方向：技术和内容	8bit
期待已久的BTC Taproot软分叉将在几小时内开启	8bit
其实说的是人生哲理	8bit
汽车行业如何玩转“Web3.0”？智己汽车“原石谷”开启区块链应用新场景！	8bit
潜在的“捡漏机会”？Web3的基础设施：去中心化域名	8bit
浅谈元宇宙的三种发展路径，它是人类文明的必然选择吗？	8bit
强调着力提升数字化管理能力	8bit
区块链	8bit
区块链NFT	8bit
区块链NFT链游	8bit
区块链的国资行动：过半央企涉足，地方国资参投区块链企业	8bit
区块链量子计算	8bit
区块链骑士	8bit
区块链数字人民币	8bit
区块链以太坊CBDC	8bit
区块链隐私公链Findora Beta主网上线Staking质押功能	8bit
区块链隐私公链Findora推出1亿美元生态系统基金	8bit
区块链游戏和NFT会是主流游戏市场下一个机遇吗？	8bit
区块链元宇宙	8bit
区块链资讯	8bit
区块律动BlockBeats	8bit
取代还是融合，NFT艺术与传统艺术碰撞会发生什么？	8bit
去中心化协议BXH被盗超1.3亿美元，部分资金已跨链到以太坊和BTC	8bit
趣味漫画科普 | 元宇宙到底是个啥？	8bit
全球区块链商业委员会今日发布了《区块链法国际杂志》第一卷第一期	8bit
全球游戏市场今年预计将创造超过 1700 亿美元的收入	8bit
人类将迎来第一个元宇宙货币？从区块链视角看Facebook改名	8bit
人们对这笔5亿美元的交易进行了猜测，它成功的引起了关注。	8bit
融资链游	8bit
融资新闻 | DeFi协议Ardana完成1000万美元融资，三箭资本领投	8bit
融资新闻 | NFT平台Pulsr完成200万美元融资	8bit
融资新闻 | 风险监测公司Solidus完成1500万美元融资，Liberty City Ventures牵头	8bit
融资新闻 | 加密货币初创公司Immunefi完成550万美元种子轮融资	8bit
融资新闻 | 加密货币初创公司Notabene完成1020万美元A轮融资	8bit
融资新闻 | 加密货币初创公司QuickNode完成3500万美元A轮融资 ，Tiger Global领投	8bit
融资新闻 | 区块链平台Telos完成800万美元融资	8bit
融资新闻 | 区块链游戏初创公司Forte完成7.25亿美元B轮融资，a16z、老虎环球基金等参投	8bit
融资新闻 | 去中心化设计平台Moralis完成1340万美元种子轮融资	8bit
融资新闻 | 游戏初创公司Mythical Games完成1.5亿美元C轮融资，a16z领投	8bit
融资新闻丨NFT 定价解决方案公司PawnHouse完成 200 万美元的融资	8bit
融资新闻丨NFT 基础设施项目ClubNFT完成300万美元种子轮融资	8bit
融资新闻丨NFT提供商GigLabs完成 450万美元融资，由Panoramic Ventures 和Dapper Labs 领投	8bit
融资新闻丨zkSync开发公司Matter Labs完成5000万美元融资，A16z领投	8bit
融资新闻丨澳大利亚加密货币投资应用 Bamboo完成300万美元融资，寻求在美国上市	8bit
融资新闻丨跨境支付公司Chipper Cash完成1.5亿美元融资，FTX领投	8bit
融资新闻丨区块链基础设施供应Alchemy完成2.5亿美元融资，A16z领投	8bit
融资新闻丨收藏卡牌交易平台Alt以逾3.25亿美元估值完成7500万美元B轮融资，Spearhead领投	8bit
融资新闻丨数字货币集团（DCG）完成7亿美元融资，软银和谷歌参投	8bit
融资新闻丨元宇宙游戏平台The Sandbox完成9300万美元融资，软银领投	8bit
如果你在etherscan中找到一个0day（零日）漏洞，你会怎么做？	8bit
如何解码以太坊智能合约数据，并批量处理相关细节？	8bit
如何看待当下的DeFi范式转变：从TVL到PCV	8bit
如今创作者经济正体现在更广泛的游戏行业	8bit
软银NFT	8bit
软银旗下基金愿景II期对NFT概念公司频频出手	8bit
洒脱喜	8bit
萨博在反对以太坊的什么？	8bit
三大链游独角兽齐聚，Axie Infinity等项目开发商如何看待NFT与链游的未来	8bit
闪电网络taproot比特币	8bit
上海市出台专项规划 利用区块链等技术推进城市数字化转型	8bit
深度解读 | 波卡双11插槽拍卖在即，100个平行插槽或将带来行业无序混乱？	8bit
深度丨为什么说元宇宙的发展是大势所趋，而不是偶然？	8bit
深链Deepchain	8bit
什么是PCV？	8bit
史玉柱：元宇宙时代必然来临但不是眼下，其发展是渐进的	8bit
使用以太坊登录：中心化身份提供商的替代方案	8bit
市场法不适用于区块链技术资产的评估	8bit
收藏 | 盘点链游（元宇宙）常用的8个数据查询网站	8bit
首尔将打造公共服务“元宇宙平台”，暂命名“元宇宙首尔”	8bit
首尔市政府将成为韩国首个提供元宇宙服务平台的地方政府。	8bit
数据：58%游戏工作室开始采用区块链技术，47%将NFT作为游戏资产	8bit
数据：距离比特币Taproot升级还有6个区块	8bit
数据资产化大跨步！广东省发布全国首张公共数据资产凭证，区块链起到了重要作用	8bit
数据资产凭证实现了从数据资源到数字资产的转变	8bit
数字人民币钱包破亿背后：政府、互联网巨头抢发红包，跨境支付已启动	8bit
随着NFT的发展，音乐、电影、游戏等行业也在积极的加入NFT领域	8bit
所有的游戏玩家都已经习惯了web3，只是他们还不知道而已	8bit
他新晋者的市场份额正强势增长，多链生态已然形成	8bit
它与以太坊有着怎样的联系？	8bit
太可能会出现 SegWit 升级时出现的社区分叉论战。	8bit
腾讯CEO马化腾：公司拥有大量探索和开发元宇宙的技术和能力	8bit
腾讯游戏副总裁、Epic创始人、英伟达、Roblox高管罕见对谈元宇宙	8bit
推特	8bit
万向峰会陈军宏演讲：元宇宙1.0到5.0的路线演进及创业方向的一些思考	8bit
万向区块链	8bit
万字长文全景解读Discord：这才是真正的“元宇宙”	8bit
王佳健	8bit
微软：为元宇宙赋能，提供全套资源支持元宇宙	8bit
微软CEO：元宇宙将把现实世界带入任何数字空间	8bit
微软认为，元宇宙是“智能云和智能边缘的巅峰之作”	8bit
微软杀入元宇宙，将于2022年上半年推出企业版的元宇宙产品	8bit
微软提供了一套全面的资源，旨在为元宇宙提供支持——将不止一个产品。	8bit
微软元宇宙	8bit
微软总裁称科技行业应配合监管机构，淡化元宇宙“炒作”	8bit
为什么 BXH 能将资金管理权限交给黑客	8bit
为什么Taproot很重要	8bit
为什么罗永浩认为我们理解的元宇宙都错了？Shaan Puri的元宇宙概念为什么更靠谱？	8bit
为什么你应该关注Taproot——比特币的下一个重大升级	8bit
未来属于多链。	8bit
稳定币	8bit
我们可能会看到区块链技术以某种新的盈利策略出现在育碧的游戏中	8bit
我们期待着游戏能与加密货币碰撞出更多的火花，终有一日功不唐捐。	8bit
我们需要为创作者提供量身定制的解决方案	8bit
吴说	8bit
物理人向数字人的过渡，它将是一个或伟大或悲伤的史诗故事	8bit
细节分析：DeFi 平台Cream Finance 再遭攻击，1.3 亿美金被盗	8bit
现在，这个指导方针已经定稿，相关说明也已经公布	8bit
详解以太坊路线图：从合并、研究等方面探讨以太坊经济和可扩展性双重升级	8bit
详解最小化反共谋基础设施MACI：链上治理中的抗勾结框架	8bit
向Web3.0转型！一文盘点社交巨头们的Crypto布局，Twitter、Facebook、Reddit...	8bit
消息人士：印度政府将对加密货币采取“渐进式”监管措施	8bit
肖毅被“双开”：曾滥用职权支持企业从事虚拟货币“挖矿”	8bit
新华网：元宇宙是虚拟和现实世界融合的载体，蕴含社交等场景变革的巨大机遇	8bit
新任纽约市长表示将把纽约打造为“Crypto创新”中心	8bit
星球日报	8bit
行业资讯	8bit
虚拟房产在二手市场爆炒	8bit
需要根据具体的藏品类型进行分析。	8bit
选出最符合自己研究习惯的数据网站	8bit
学习比特币（尤其是 Taproot）的过程会告诉读者，什么才是真正的 “密码学货币”	8bit
迅鳐科技	8bit
央行行长易纲：数字人民币试点场景已超过350万个，下一步将有针对性地完善数字人民币的设计和使用	8bit
鳐观链界 | 中国区块链专利申请量全球第一，数量达3.3万件	8bit
要以发展的眼光看待项目	8bit
一旦我们有了工具，解码的过程就相对简单了	8bit
一个三方构成的新格局逐步形成。	8bit
一天募集 5700 万美元，Multicoin领投的UXD是破局者，还是稳定币领域的又一个深坑？	8bit
一文读懂芝商所的微型以太坊期货MET	8bit
一文了解多边央行数字货币桥mBridge，未来会和以太坊丰富的生态联动吗？	8bit
一文了解万向峰会精彩瞬间。	8bit
一文了解与以太坊兼容的Filecoin虚拟机FVM，它将为网络带去什么？	8bit
一文梳理FATF最新监管指南对加密各个领域有何变化？	8bit
一文梳理元宇宙（游戏变革ing）	8bit
一文说透元宇宙与Web3时代的重要基础设施：Rollup、波卡、Cosmos...	8bit
一文纵览“万向峰会”演讲嘉宾都讲了些什么|金句集锦	8bit
一些分析人士表示，增强现实带来的滥用风险甚至比社交媒体更大	8bit
一周链上动向，一手即刻掌握。	8bit
以 GameFi土地资产为例分析游戏经济模型的转变 ｜行业观察	8bit
以太坊	8bit
以太坊：无限接近于“元宇宙”……	8bit
以太坊DeFiNFT	8bit
以太坊ENS	8bit
以太坊Layer 2	8bit
以太坊RollupLayer 2	8bit
以太坊多链Avalanche	8bit
以太坊分片Rollup	8bit
以太坊扩容与生态之争：跨链对垒 EVM丨产业	8bit
以太坊预计将在2022年Q2进行合并，合并后首要任务为解锁Staking合约中锁定的ETH	8bit
以太坊元宇宙	8bit
以无畏精神探索新事物，这是加密世界真正的密码	8bit
隐藏在众目睽睽之下：复盘etherscan的零日漏洞	8bit
隐私公链Findora联合Gitcoin推出全球黑客松活动	8bit
印度Crypto领域升温，国家政党和领导人将焦点放在区块链技术之上	8bit
印度总理召开Crypto会议，敦促取缔误导性广告	8bit
英伟达元宇宙	8bit
拥有强大创意产业的韩国，正在发力元宇宙	8bit
用户将能够在虚拟世界中共享Office文件和功能	8bit
由于去中心化域名和账户体系可以承载应用、网站和用户身份，因此有理由相信，这是 Web3 世界中不可或缺的一环。	8bit
游戏巨头Epic Games为何坚定看好元宇宙？其做了哪些布局？	8bit
游戏巨头育碧计划创建区块链游戏，以实现更多Play-to-Earn	8bit
游戏巨头育碧有意自创「Play to Earn」区块链游戏	8bit
又一支付巨头要入场了？	8bit
宇宙的探索也充满着挑战，需要警惕	8bit
预计2022年将成为以太坊Rollup之年。	8bit
预计元宇宙市场规模将在2024年达到8000亿美元	8bit
元宇宙	8bit
元宇宙：定义尚无定论 拥抱仍需理性	8bit
元宇宙：条条大路通以太坊。	8bit
元宇宙到底什么时候能真正到来？	8bit
元宇宙到底是个啥？有哪些机遇？	8bit
元宇宙到底是啥？对互联网来说意味着什么？它会催生一个怎样的“平行世界”？	8bit
元宇宙概念热门区块链项目，你了解多少？	8bit
元宇宙是承载人类虚拟活动的平台，核心魅力在于承载了人的虚拟身份和虚拟资产！	8bit
元宇宙是人类未来的数字化生存	8bit
元宇宙所带来的巨大机遇和革命性作用是值得期待的	8bit
元宇宙之心MetaverseHub	8bit
元宇宙中的大部分“数字资产”必须完全的属于个人	8bit
元宇宙周刊丨​微软聚焦沉浸式XR会议；首家元宇宙行业协会揭牌；百度推出VR社交APP	8bit
元宇宙最大受益者是谁？答案是“卖铲人”--英伟达！	8bit
越来越多的大厂将“元宇宙”作为第二条增长曲线	8bit
云中子科技陈军宏：Metaverse可分5个阶段，从1.0到2.0可能需要10年时间	8bit
在看待“元宇宙”这件事上，人们的观点是截然不同的	8bit
在推动区块链产业的发展上，央企和地方国有资本都起着不可或缺的作用	8bit
在这份报告中，我们解读了波卡的技术和哲学基础	8bit
在这一范式当中，参与者的定义将不再是一元的	8bit
扎克伯格：从现在开始，我们将是元宇宙优先，而不是 Facebook 优先。	8bit
扎克伯格公开信：为了元宇宙，我们更名为Meta	8bit
扎克伯格想打造的，远不只是「元宇宙公司」	8bit
这篇文章的目标是为设计一种“非合作二次方投票”，或“抗勾结二次方投票”的机制做准备。	8bit
证券日报	8bit
芝商所推出“微型”加密货币衍生品产品取得了不错的成绩	8bit
指南中的建议不是规则或规定，而是各国应遵循的标准，以打击洗钱和恐怖注意融资。	8bit
智能合约	8bit
智能汽车+区块链+Web3.0，是未来吗？	8bit
中信证券研究部｜关于元宇宙的未来猜想和投资机遇	8bit
周蓬岸：元宇宙的史前史	8bit
专注于某些特定任务的公会可能会因为专业化而 表现得非常出色	8bit
邹传伟：如何理解元宇宙的经济学	8bit
"1.mint: 使用snx5倍抵押借出susd，动态债务额为当前susd占所有snx债务池比例	remark
"Andre Cronje,vaults,earn,lending,cover	remark
"ccl智能合约（dpos），研发中，已出现的功能都是围绕stake来的	remark
"coinbase投资；	remark
"Liquidater可以发起清算；	remark
"nominator	remark
"pos:中继链、平行链(转接桥)、链中链	remark
"公链，CBC英文全称为“Correct-by-Construction”，意为按构建逐步校正	remark
"可变利率、闪电贷；	remark
"三个方向：	remark
$5 per token，12-month lock up with a 12-month release	remark
--(yearn->stablecoin->curve->YFI)"	remark
09年成立的新加坡公司，娱乐、游戏平台，B端服务、工会服务，主流游戏较少	remark
--0私募0预留(公平)	remark
1.94u价格买入1048个，大头提到eth/零头提到bsc，已清erc20	remark
100cards入门	remark
2.exchange: 卖出susd获得目标代币如BTC	remark
20210530查看主链日均1w交易，ksm"	remark
3.BTC涨则自己获益，BTC跌则亏损	remark
9.14日存usdc以0.08u价格ido,PAI是稳定币，治理代币PRT	remark
account base	remark
Alien Worlds	remark
blog,snapshot	remark
BTC/ETH加密暗池(一拆多)交易协议	remark
B端方案	remark
B端方案，还是通过文档提交人工认证	remark
c2c的defi投资策略基金	remark
collator	remark
confidence.move	remark
csl(pow，类似比特币的utxo模型，支持多对多），首席营销官，非洲概念，主网还未上线	remark
Decentralize Identity Foundation基础服务，没有发币	remark
defi的基石，排名只计算了流动性，所以curve的排名被大大低估	remark
defi收益的根源来源于流动性，牛市行情下才会有源源不断的流动性	remark
dex，基于serum，GUI友好，支持机器人和永续合约	remark
Disputer解决争议；	remark
Equilibrium的ksm版本，ksm上defi平台	remark
ERC1155，半NFT	remark
ERC20	remark
eth,gala,town,bat四种代币	remark
eth2.0质押平台	remark
fisher	remark
FTX没有为其赋能，不像BSC	remark
gnosis拍卖占5%的50m TCR代币，平台上线5天从0.05到0.075,9.15日结束	remark
Gods unchain创始人	remark
harvest.finance，官方理财平台	remark
ido平台，可以stake	remark
Inter/Dropbox工程师，POH历史证明(base-POS)	remark
Javascript发明者，广告浏览器	remark
kmz侧链，mpc，研发中，研发为公司托管"	remark
Layer2	remark
layer2聚合器，1.5以下考虑入一点	remark
metamask、zapper、defisaver都在用	remark
NEO，跨链，东京的实验室	remark
NFT二层方案Immutable X	remark
nft武士游戏	remark
PCV协议控制价值，跟时间绑定的Bond机制，期权pOHM=1OHM - 1Dai，3:3赌博理论，90%手续费返还用户	remark
pokerstar日活1.5w，季度佣金2亿U	remark
raydium公募价格0.02	remark
raydium平台NFT孵化区第一个项目，5000个形象3sol一张票最多9sol	remark
realworld,coinlist上市	remark
reddit打赏币\facebook\twich	remark
roin测链	remark
rollup	remark
rollup lab，多轮交互欺诈证明	remark
serum孵化，defi门户：质押，IDO，LP	remark
Social Netowrk	remark
solana	remark
sql调用，基础API/项目API/预言机API	remark
substrate:基于RUST的平行链开发框架，node/frame/core"	remark
sushi的ido平台miso首个产品6月1日凌晨1点3u的价格卖给600个白名单	remark
twitter	remark
V3、Optimistics	remark
validator	remark
Web3.0预言机，dapps本身接入API3即可对外提供预言机服务	remark
yamp弹性稳定币，分叉于算法稳定币ampl，套娃币，上线24小时BUG	remark
波卡抵押稳定币	remark
波卡基金会IDO	remark
波卡跨链defi平台，旗下产品pokaswap	remark
波卡先行版，受卡槽拍卖影响，20210530近半个月交易量翻10倍	remark
部分抵押，治理代币tribe；fei价变低时用抵押资产购入fei，fei价过高时生成fei注入市场，交易通过uniswap	remark
参与度证明	remark
测试网Mandala TC6地址5FRDJW9WLTphfmf5yTSu2LMJAVFmDS353x3TyT5pqugnVDwA	remark
出借利率 = 贷款利率 * 利用率"	remark
初代算法稳定币，价高则10天内平均通胀达到目标值，价低则销毁存量AMPL；容易形成fomo，治理代币Forth	remark
创作者，粉丝代币	remark
纯手游，YGG入股，Badge #14706（20211016）	remark
大众点评	remark
代币CHP，主要基于usdt交易，用户体验做的不错，dau 100左右	remark
代币反应堆，defi做市商	remark
单独的bitski钱包	remark
低门槛STO	remark
抵押率低于150平仓手续费13%；稳定费率0.5%~20%；借出稳定币DAI(最低5000dai)；最后贷款人、全局清算机制；最低抵押	remark
第三方评估	remark
第三方评估，自定义信用评分模型	remark
点对点借贷；"	remark
点对点匿名，开发成本高	remark
--多协议智能转仓	remark
二代算法稳定币，价格下跌时卖出债券bab并销毁收到的bac	remark
二级账号，一站式DEFI服务，各种借贷头寸转移组合	remark
发行2亿，每季度利润20%销毁至1亿	remark
复制证明、时空证明、权益证明	remark
杠杆交易	remark
更友好的curve平台，帮助crv持有者领取空投，比yearn手续费低，可赚取cvx，需要手动进行复利投资	remark
公链，保护隐私的区块链云计算平台,价格走低	remark
公链，前身是CodaProtocol，每个区块只有一条推文大小,最小的区块链，最快的速度，zk-snarks	remark
公益平行链，用于发行通用资产和NFT	remark
供应链、国产	remark
共识算法CPU友好,筹码在矿池集中	remark
购买NFT认证公民	remark
固定利率	remark
官方dex为matcha	remark
还未开放注册！！	remark
韩国tera公司基于comos开发对标各法币的稳定币	remark
和aave/compound联动；"	remark
滑点杀手，合成资产平台，交易平台独立成kwenta，抵押率500%但是能进行挖矿，已迁移至Layer2 Optimistic网络;	remark
基于arweave，基于zora创建NFT	remark
基于bitcoin的智能合约，转移证明POX，	remark
基于cosmos的跨链defi平台，基于稳定币usdx，币安火币都在用这个技术方案	remark
基于cosmos生态，其他跨链协议的竞争	remark
基于DAG的兼容EVM的defi专用高速链，AC推荐	remark
基于monero公链，离岸银行,使用chainlink，xhv价高时就吐出少量xhv。流动性不足而失败	remark
基于NFT和分片设计的五种节点的工作流公链	remark
基于Ont本体项目的信用方案	remark
基于stacks，已发miacoin\nycoin，质押stx得到btc，质押citycoin得到stx	remark
基于波卡的defi平台，类似compound/aave	remark
价格走低"	remark
兼容以太坊合约的平台，基于purestake方案开发	remark
借贷获得利息同时获得代币；	remark
借款能力（borrowing capacity）=抵押资产价值 * 抵押系数	remark
开放世界，治理代币mana，游戏货币land，类似元宇宙可联系现实活动	remark
跨境结算	remark
快速、安全、稳定的数字支付平台。	remark
乐观机制，两个角色都有抵押UMA防止作恶；	remark
类makerdao抵押eth得到lusd(最低2000)，清算机制优化成3层清算降低抵押率；L1稳定币有10%的价差鼓励LP；L2最高150%抵押率，按抵押率由高到低分配清算额度；L3全局清算；自己不提供前端；	remark
类theta可作为底层游戏平台，游戏资产互通，热门游戏townstar、spidertank、mirandus(rpg夜晚模式),fortified	remark
类似curve	remark
类似opensea	remark
类似YFI	remark
类似基金策略	remark
李斌,新加坡	remark
利用创新型最小化中心化预言机(DVM: Data Verified Merchain)合成锚定现实资产的合约代币：Liquidator清算者,Disputer争议者；可以锚定任何价格资产	remark
链上任务网络	remark
零和博弈，永不爆仓；	remark
匿名信用评分	remark
平行链2000，波卡defi平台，稳定币ausdt,还在测试网阶段；1ksm可获12kar	remark
平行链2001，解决有限资产在 Staking 质押和 DeFi 应用中质押的矛盾选择问题	remark
平行链2004，web3.0 时代的隐私计算云平台	remark
平行链2007，波卡生态的Layer2解决方案	remark
期权交易	remark
区块链上操作系统	remark
区块链世界的paypal、alipay	remark
趣味性高，精灵养成、战斗系统；辅助代币SLP爱情药水，用于axie繁殖；也包含地皮系统等；	remark
三条链MMO，类似天堂	remark
沙盒游戏类似我的世界，成熟游戏公司转型区块链；代币SAND、NFT为LAND；在opensea交易，像素渣渣	remark
上大交易所；	remark
上线即巅峰，认证方式联合KeyFi仅提交简单的国家、护照等，没有技术认证	remark
使用ksm内部crowdloan机制众贷	remark
视频流，质押需要10000个theta	remark
受监管的标记现实世界资产的稳定币	remark
数据中间层，给区块链建索引方便查询，github登录，可以stake	remark
算法稳定币	remark
索引者（indexer）、查询者（查询需求者）、策展人（Curator）、委托者、以及监督者（Fishermen）和仲裁者（Arbitrator）	remark
锁定DAO或DAO_LP，中奖之后使用USDC进行IDO	remark
锁定pols(2u)500u才有一个抽奖资格	remark
太子项目，SOL底层交易平台，各GUI交易汇集到Serum才能提供订单簿级别的交易，LP，Learn做题拿收益	remark
体育、socios.com	remark
通过机枪池提高资金效率；初始3W治理代币YFI已经分发完毕；与curve联动的初始的高收益LP挖矿阶段已经结束(v1)；	remark
同瑞波币	remark
同上	remark
文件存储，可以stake，彻底解决防火墙问题	remark
无矿工、通缩模型（手续费销毁）	remark
吸引更多fei-tribe流动性挖矿；	remark
小额支付	remark
需要kyc	remark
衍生品赛道领头羊	remark
一站汇总整合各种平台协议	remark
依赖于预言机"	remark
已提交资料在过KYC	remark
已正式发布并支持uniswap	remark
以太坊隐私解决方案，加密管理，动态访问,Coinbase/Coinlist/V神	remark
音乐创作	remark
永续合约，上线arbitrum，500万融资	remark
用dai下注，20210516授权mm_eth账号消耗33u	remark
由defipluse团队创建，已上线polygon	remark
由defiprime团队创建	remark
与MakerDao一样超额抵押生成稳定币mim，只是抵押品变成二次收益券	remark
与Yearn同源，抵押DAI获得alUSD，存入Yearn获取收益，收益自动偿还债务	remark
预言机、Optimisitc	remark
越南游戏吃鸡、MOBA	remark
账号分布：https://solanabeach.io/supply	remark
争议期48小时；"	remark
专业的类bloomberg交易终端	remark
自己的链	remark
最小质押100sdm	remark
# Coins	spot
# Markets	spot
Aave    	spot
AAX	spot
ABCC	spot
ACDX    	spot
ACE	spot
AED, ARS, AUD	spot
AEX	spot
ALL, AUD, BRL	spot
Altcoin Trader  	spot
Alterdice  	spot
and +1 more	spot
and +2 more	spot
and +3 more	spot
and +4 more	spot
and +43 more	spot
and +45 more	spot
and +47 more	spot
and +7 more	spot
AOFEX	spot
ApeSwap.Finance (Polygon)  	spot
Apollox	spot
APROBIT	spot
Artis Turba	spot
Aryana  	spot
AscendEX (Bitmax)	spot
ATAIX	spot
AUD	spot
AUD, EUR, GBP	spot
AUD, GBP	spot
AUD, GBP, USD	spot
Avg. Liquidity	spot
Azbit	spot
B2BX    	spot
Balancer(v2)    	spot
BankCEX	spot
BaseFEX	spot
Beaxy  	spot
Bgogo	spot
BHEX (BlueHelix Exchange)	spot
Bibox  	spot
Biconomy    	spot
BigONE	spot
Binance	spot
Binance JEX	spot
Binance TR	spot
Binance.US	spot
Bingbon	spot
BiONE	spot
Bit.com	spot
bit4you	spot
Bitay  	spot
Bitazza	spot
Bitbank	spot
BitBay  	spot
Bitbns  	spot
Bitbuy  	spot
Bitci  	spot
BitClude    	spot
BitcoinTrade    	spot
Bitcoiva	spot
BitCoke	spot
Bitex.la    	spot
BITEXBOOK  	spot
Bitexen	spot
BITEXLIVE  	spot
Bitfinex	spot
bitFlyer	spot
BitForex	spot
Bitfront	spot
Bitget	spot
Bitglobal	spot
Bithesap	spot
Bithumb	spot
Bithumb Singapore  	spot
Bitkub	spot
BitMart	spot
BitMEX  	spot
Bitonic	spot
BitoPro	spot
Bitpanda Pro	spot
Bitribe	spot
Bitrue	spot
Bits Blockchain	spot
Bitso	spot
Bitstamp	spot
Bitsten	spot
BITStorage  	spot
Bittrex	spot
BitTurk	spot
Bittylicious    	spot
BitUBU	spot
Bitvast	spot
Bitvavo	spot
BitWell	spot
Bleutrade  	spot
Blockchain.com	spot
BQT	spot
BRL	spot
BRL, EUR	spot
BTC Markets	spot
BTC Trade UA    	spot
BTC-Alpha  	spot
BTCBOX  	spot
BTC-exchange    	spot
BtcTurk | Pro	spot
BTSE    	spot
Buda    	spot
Bvnex  	spot
BW.com  	spot
Bybit	spot
Capital DEX	spot
Cat.Ex  	spot
CBX	spot
CEX.IO	spot
ChainX	spot
Changelly PRO  	spot
Chiliz	spot
Coinbase Exchange	spot
CoinBene	spot
Coinbit	spot
CoinCasso  	spot
Coincheck	spot
CoinCorner  	spot
CoinDCX	spot
Coindeal    	spot
Coineal	spot
CoinEx	spot
CoinFalcon  	spot
CoinField	spot
CoinFLEX	spot
Coingi  	spot
CoinJar	spot
Coinlist Pro	spot
CoinMate    	spot
CoinMetro  	spot
Coinone	spot
Coinsbit	spot
Coinsuper  	spot
CoinSwap.com (BSC)  	spot
CoinTiger  	spot
Coinut  	spot
CoinW	spot
Coinzo  	spot
CoinZoom	spot
Compound	spot
COSS    	spot
C-Patex	spot
Crex24  	spot
CROSS exchange  	spot
CrossTower	spot
CRXzone	spot
Crypterum  	spot
Crypto.com Exchange	spot
Cryptology	spot
CryptoMarket    	spot
Cryptonex  	spot
Currency.com	spot
Dcoin  	spot
Decoin  	spot
Deepcoin	spot
Delta Exchange	spot
Deribit	spot
Dex-Trade	spot
DFX Finance(Ethereum)  	spot
DigiFinex	spot
digitalexchange.id  	spot
Dove Wallet	spot
DragonEX	spot
Dsdaq	spot
Ecxx    	spot
Emirex  	spot
EQONEX	spot
eToroX	spot
EUR	spot
EUR, CHF, TRY	spot
EUR, GBP	spot
EUR, USD, GBP	spot
EUR, USD, RUB	spot
Exchange Score	spot
EXIR    	spot
ExMarkets	spot
EXMO	spot
Exnomy  	spot
Exrates	spot
EXX	spot
FarhadMarket	spot
Fatbtc	spot
Felixo  	spot
Fiat Supported	spot
Finexbox    	spot
Flybit  	spot
FMFW.io (Bitcoin.com Exchange)	spot
FOBLGATE	spot
Folgory	spot
FreeRiver  	spot
FreiExchange	spot
FTX	spot
FTX US	spot
Gate.io	spot
Gatehub	spot
GDAC    	spot
Gemini	spot
Giottus	spot
Globe Derivative Exchange	spot
Globitex    	spot
GokuMarket	spot
GOPAX  	spot
Graviex	spot
Hanbitco    	spot
Heat Wallet	spot
HitBTC	spot
Hoo	spot
Hotbit  	spot
HOTBIT KOREA	spot
Hotcoin Global  	spot
Huobi Global	spot
Huobi Korea	spot
IDCM	spot
IDR	spot
Independent Reserve	spot
Indodax	spot
IndoEx  	spot
INR	spot
INR, USD, EUR	spot
IRR	spot
ISK	spot
ISX	spot
itBit  	spot
JPY	spot
Jswap	spot
Jubi	spot
KickEX	spot
Koinbazar  	spot
Koinim  	spot
Korbit	spot
Kraken	spot
KRW	spot
KRW, EUR	spot
KuCoin	spot
KULAP	spot
Kuna    	spot
KuSwap  	spot
Kwikswap    	spot
KyberDMM (Avalanche)    	spot
KyberDMM (BSC)  	spot
KyberDMM (Polygon)  	spot
LATOKEN	spot
LBank	spot
LCX Exchange    	spot
Liquid	spot
LiteBit.eu  	spot
LOEx	spot
LuaSwap	spot
Luno	spot
Lykke Exchange  	spot
Mandala Exchange	spot
MAX Exchange	spot
Mercado Bitcoin	spot
Mercatox	spot
MEXC	spot
Mexo Exchange  	spot
MoonSwap(Moonriver)	spot
MXN, ARS	spot
Name	spot
Namebase    	spot
Narkasa	spot
NiceHash    	spot
Nominex	spot
NovaDAX	spot
OceanEx	spot
Okcoin	spot
OKEx	spot
Omgfin  	spot
OTCBTC	spot
P2PB2B  	spot
Paribu	spot
Paritex	spot
PayBito	spot
Paymium	spot
Phemex	spot
Pionex	spot
Poloniex	spot
Polyx  	spot
Prizmbit    	spot
ProBit	spot
ProBit Global	spot
Put on your metamask!!!	spot
qTrade  	spot
Rekeningku.com	spot
Resfinex    	spot
Ripio  	spot
RippleFox  	spot
RUB, TRY	spot
RuDEX  	spot
SafeTrade  	spot
Satang Pro  	spot
SecondBTC	spot
Serenity	spot
SINEGY Marketplace  	spot
SouthXchange	spot
StakeCube	spot
STEX	spot
StormGain  	spot
THB	spot
THB, SGD, AUD	spot
The Rock Trading	spot
Tidebit	spot
Tidex	spot
TimeX  	spot
TOKENCAN    	spot
Tokenize Xchange    	spot
Tokenomy	spot
Tokocrypto	spot
TOKOK  	spot
TOPBTC	spot
TradeOgre  	spot
Triv Pro    	spot
TRY	spot
TWD	spot
Txbit  	spot
Ubeswap	spot
Unocoin	spot
Upbit	spot
USD	spot
USD, AED, ARS	spot
USD, AUD, NZD	spot
USD, EUR	spot
USD, EUR, GBP	spot
USD, EUR, RUB	spot
USD, JPY, EUR	spot
USD, RUB, EUR	spot
VALR    	spot
Valuex  	spot
VCC Exchange	spot
VELIC  	spot
Venus	spot
VinDAX  	spot
ViperSwap  	spot
Virtuse Exchange    	spot
Volume Graph (7d)	spot
Volume(24h)	spot
WazirX  	spot
WBF Exchange	spot
Weekly Visits	spot
WhiteBIT	spot
WOO Network	spot
Xcalibra	spot
XT.COM	spot
YoBit	spot
YunEx	spot
Zaif	spot
ZB.COM	spot
ZBG	spot
ZebPay  	spot
ZG.com	spot
Zipmex	spot
ZT  	spot
icp	coin
eth	coin
btc	coin
doge	coin
lite	coin
ada	coin
sol	coin
vet	coin
matic	coin
uni	coin
fil	coin
solanium	coin
link	coin
dot	coin
bnb	coin
cake	coin
dai	coin
aave	coin
mkr	coin
raydium	coin
axie	coin
ksm	coin
fei	coin
comp	coin
chz	coin
loopring	coin
yfi	coin
sushi	coin
serum	coin
civic	coin
enj	coin
snx	coin
mana(Decentral Land)	coin
GRAPH(GRT)	coin
curve	coin
Karula(Acala)	coin
fantom	coin
uma	coin
SherpaX(ChainX)	coin
0x(zrx)	coin
cfg	coin
Super	coin
sand	coin
Rep(Augur)	coin
balancer	coin
gitcoin	coin
gala	coin
api3	coin
ampl	coin
gero	coin
dpi(defi pulse index)	coin
xor(sora)	coin
alchemix	coin
dao(daomaker)	coin
cardstart(cards)	coin
charli3(c3)	coin
ftt	coin
Lido	coin
liquity	coin
coin poker	coin
Shiden(Plasm)	coin
mask	coin
yam	coin
kp3r	coin
convex	coin
truefi	coin
yield.app	coin
illuvium	coin
Yield Guild Games	coin
CQT(covelate)	coin
farm	coin
Ledger Score	coin
Khala(Phala)	coin
mln(Enzyme)	coin
instadapp	coin
o3	coin
Depay	coin
Equilibrium	coin
Virtue Poker	coin
Upbots	coin
Moonriver(Moonbeam)	coin
btrst	coin
grape	coin
dydx	coin
zapper.fi	coin
solfarm	coin
saber	coin
cyber sumarai	coin
parrot	coin
zerion	coin
opyn	coin
maple finance	coin
tracer	coin
hegic	coin
notional	coin
yield.is	coin
KeyFi	coin
xrp	coin
xlm	coin
eos	coin
monero	coin
celo	coin
xhv	coin
fida	coin
Genshiro	coin
Babylon Finance	coin
cardax(cdx)	coin
defi saver	coin
debank	coin
zksync	coin
Redkite(PKF)	coin
tokensets	coin
dexguru	coin
Biforst，代币BNC	coin
optimism	coin
arbitrum	coin
sundaeswap	coin
mina	coin
Kava	coin
slingshot	coin
theta	coin
vega	coin
cspr	coin
flow	coin
nucypher	coin
rose	coin
fold	coin
TrustToken	coin
ren	coin
bac	coin
luna	coin
polkastart	coin
tlm	coin
standard protocol	coin
shell(statemine/statemint)	coin
cover	coin
bat	coin
dodo	coin
solanart	coin
gnosis	coin
CredMark	coin
Arcx	coin
WingFinance	coin
Ontology	coin
SelfKey	coin
dif	coin
rally	coin
idena	coin
aleo	coin
Guild of Guardians	coin
star atlas	coin
immutableX	coin
ilu gog 门票要求，玩法介绍，角色介绍	coin
gala、mana玩法视频	coin
ohm	coin
tokemak	coin
spell（mim）	coin
breederdao	coin
meritcircle	coin
projectseed	coin
thetan	coin
bitclout(deso)	coin
mirror	coin
audius	coin
yup	coin
stacks	coin
citycoin	coin
citydao	coin
ada	coin
bsc	coin
cex	coin
coinlist	coin
dao	coin
defi	coin
defi manager	coin
defi2.0	coin
dex	coin
eth	coin
game	coin
ido	coin
invest	coin
king	coin
kyc	coin
Layer2	coin
lend	coin
nft	coin
option	coin
oracle	coin
plo	coin
poker	coin
polka	coin
RPG	coin
solana	coin
stake	coin
sto	coin
wallet	coin
web3.0	coin
保险	coin
宠物	coin
底层协议	coin
二线	coin
工会	coin
公链	coin
供应链	coin
固定利率	coin
广告	coin
合规稳定币	coin
加密资产稳定币	coin
借贷	coin
跨链	coin
理财	coin
略	coin
平台	coin
沙盒	coin
社交	coin
数据服务	coin
算法稳定币	coin
太空	coin
特色	coin
体育	coin
稳定币	coin
稳定币交易所	coin
稳定币平台	coin
新一代dex	coin
信用身份	coin
衍生品	coin
游戏	coin
预测	coin
支付	coin
指数	coin
